the Council of the European Communities	Rada Wspólnot Europejskich	#g
of the one part	z jednej strony
the Swiss Federal Council	Szwajcarska Rada Związkowa	#mw
of the other part	z drugiej strony
I have the honour	Mam zaszczyt	#g
products of the clock and watch industry	wyrób zegarmistrzowski	#mw
clock and watch industry	przemysł zegarmistrzowski	#mw
adopt additional provisions	przyjąć postanowienia dodatkowe	#g
close cooperation	ścisła współpraca	#mw
at the same time as	jednocześnie z
taking note of	przyjmując do wiadomości	#g
Chambre suisse de l'horlogerie	Szwajcarska Izba Zegarmistrzostwa	#mw
it shall be understood that	postanawia się, że
in the event of a dispute about	w przypadku zakwestionowania #+gen -- tag as prep?
equivalence of quality	równoważność jakości	#g
acknowledge receipt	potwierdzić otrzymanie	#g
letter of today	list z dnia dzisiejszego
which reads as follows	o następującej treści	#not exact! lit: of (the) following contents
any interested party	każda z zainteresowanych Stron	#adj? prob. better as a noun
bezzwłocznie	forthwith	#a /real/ adj
Joint Committee	Komitet mieszany	#mw
Joint Commission	Komisja mieszana	#mw
at its following meeting	na najbliższym posiedzeniu	#lit: at the nearest sitting
for the purposes of	w celu #+gen - prep?
with the aim of	w celu #+gen - prep?
Contracting Parties	Umawiające się Strony	# mw
any difficulties that might arise	trudności, które mogłyby wystąpić
Nothing in the agreement shall prevent	Żadne z postanowień Umowy nie wyłącza możliwości
Compensatory Charge	opłata kompensacyjna	#mw
A Joint Committee is hereby established	Powołuje się komitet mieszany
for this purpose	w tym celu
