Abaso	Abbás	NOM
Abelo	Abel	PERS
Adamo	Adán	BIB, NOM, PERS
Adam	Adán	BIB, NOM, PERS
Adolfo	Adolfo	
Aerpumpilo	Máquina Neumática	
Afriko	África	GEOG
Afrodito	Afrodita	MIT
Afrodita	Afrodita	MIT
Aglo	Águila	AST
Alaho	Alà	ISL, REL
Alasko	Alaska	GEOG, POL
Altairo	Altair	AST
Altaro	Altar	
Amazono	El Amazonas	GEOG
Ameriko	América	GEOG
Amoro	Amor	MIT
Amoro	Cupido	MIT
Amoro	Eros	MIT
Amsterdamo	Amsterdam	GEOG
Andromedo	Andrómeda	AST, MIT
Anglujo	Inglaterra	GEOG
Antarkto	Antártica	GEOG
Antono	Antonio	NOM
Antverpeno	Amberes	GEOG
Araba Duoninsulo	Península arábiga	GEOG
Araba Maro	Mar arábigo	GEOG
Arabujo	Arabia	GEOG
Argentino	Argentina	GEOG
Aristotelo	Aristóteles	NOM, PERS
Arturo	Arturo	NOM
Arĥimedo	Arquimedes	PERS
Atlantiko	Oceano Atlántico	GEOG
Atlantiko	Atlántico	GEOG
Avesto	Avesta	REL
Azio	Asia	GEOG
Aŭroro	Aurora	MIT
Aŭrora	Aurora	MIT
Aŭstrala Krono	Corona Austral	AST
Aŭstralio	Australia	GEOG
Babelo	Babel	BIB
Babelturo	Torre de Babel	BIB, ESP, FRAZ
Babilonio	Babilonia	HIS
Bagdado	Bagdad	
Baleno	Ballena	AST
Balta Maro	Mar Báltico	GEOG
Baltiko	Báltico	ARK, GEOG
Baltiko	mar Báltico	ARK, GEOG
Barato	India	GEOG
Bavarujo	Baviera	GEOG
Belgio	Bélgica	GEOG
Belgujo	Bélgica	GEOG
Beogrado	Belgrado	GEOG
Berenica Haro	Cabellera de Berenices	
Beringa Markolo	Estrecho de Bering	GEOG
Beringo	Bering	PERS
Berlino	Berlín	GEOG
Bernardo	Bernardo	NOM
Biblio	Biblia	
Boreala Krono	Corona Boreal	AST
Bovo	Tauro	AST
Brabanto	Brabante	GEOG
Brandenburgo	Brandeburgo	GEOG
Brazilo	Brasil	GEOG
Brita Insularo	Islas Británicas	GEOG
Britujo	Gran Bretaña	GEOG
Bruselo	Bruselas	GEOG
Bruĝo	Brujas	GEOG
Bulgarujo	Bulgaria	GEOG
Cefeo	Cefeo	
Centaŭro	Centauro	
Cerbero	Cancerbero	FIG, MIT
Cicerono	Cicerón	BELE, PERS
Cigno	Cisne	
Cirkelo	Compás	
Dankofesto	Día de Acción de Gracias	KAL
Dankotago	Día de Acción de Gracias	KAL
Danubo	Danubio	GEOG
Dejmo	Deimos	AST
Delfeno	Delfín	AST
Demetrio	Demetrio	NOM, PERS
Drako	Dragón	AST
Edeno	Edén	BIB
Eden	Edén	BIB
Eduardo	Eduardo	NOM
Efeso	Éfeso	BIB, GEOG, HIS
Egiptujo	Egipto	
Elizeo	Elíseo	MIT
Eneo	Eneas	NOM, PERS
Epifanio	Epifanía	KRI
Ernesto	Ernesto	NOM
Esperanto	Esperanto	LIN, PERS
Eŭfrato	Eúfrates	GEOG
Eŭgeno	Eugenio	NOM
Eŭropo	Europa	AST, GEOG, MIT
Fenicio	Fenicia	GEOG, HIS
Fiŝoj	Piscis	AST
Flandrio	Flandes	GEOG
Flandrujo	Flandes	GEOG
Fobo	Fobos	AST
Forno	Horno	AST
Francio	Francia	GEOG
Francujo	Francia	GEOG
Frisio	Frisia	GEOG
Frisujo	Frisia	GEOG
Gaŭso	Gauss	PERS
Gelderlando	Güeldres	GEOG
Gento	Gante	GEOG
Georgo	Jorge	NOM
Germanio	Alemania	GEOG
Germanujo	Alemania	GEOG
Golgoto	Calvario	GEOG, KRI
Granda Ursino	Osa Mayor	AST
Groningeno	Groninga	GEOG
Gruo	Grulla	AST
Hago	La Haya	GEOG
Hamburgo	Hamburgo	GEOG
Henegovio	Henao	GEOG
Hermeso	Hermes	MIT
Hidro	Hidra	AST
Hieronimo	Jerónimo	NOM
Hinda Oceano	Oceano Índico	GEOG
Hindujo	India	GEOG
Holando	Holanda	GEOG
Homero	Homero	PERS
Horloĝo	Reloj	AST
Hugo	Hugo	NOM
Hungario	Hungría	GEOG
Hungarujo	Hungría	GEOG
Iliado	Ilíada	BELE
Indiano	Indio	AST
Internacia Labor-Organizaĵo	Organización Internacional del Trabajo	EKON
Internacia Labor-Organizaĵo	OIT	EKON
Internacia Mona Fonduso	Fondo Monetario Internacional	EKON
Internacia Mona Fonduso	FMI	EKON
Irako	Iraq	GEOG, HIS
Irlando	Irlanda	GEOG
Jerusalemo	Jerusalén	GEOG
Jesuo	jesús	KRI, PERS
Johanino	Juana	NOM
Johano	Juan	NOM
Jordanio	Jordania	GEOG
Jupitero	Júpiter	AST, MIT
Kabalo	cábala	REL
Kaloĉajo	Kalocsay	ESP, PERS
Kalvario	Calvario	GEOG, KRI, RAR
Kalvino	Calvino	KRI, PERS
Kamĉatko	Kamchatka	GEOG
Kankro	cáncer	AST
Kaprikorno	capricornio	AST
Kareno	Quilla	
Karesmo	cuaresma	KAT
Karloreĝo	Charleroy	GEOG
Karolo la Granda	Carlomagno	HIS, PERS
Kasiopeo	Casiopea	AST, MIT
Kaspio	Mar Caspio	GEOG
Kolombo	Paloma	
Konfuceismo	Confucianismo	
Konfuceo	Confucio	PERS
Konstantinopolo	Constantinopla	HIS
Koreujo	Corea	GEOG
Korvo	Cuervo	
Koĉero	Cochero	
Kristnasko	navidad	KRI
Kristo	Cristo	KRI
Kruco	Cruz del Sur	AST
Suda Kruco	Cruz del Sur	AST
Lakta Vojo	Vía Láctea	AST
Lakta Vojo	Camino de Santiago	AST
Laplaco	Laplace	PERS
Lapteva Maro	Mar de Laptev	GEOG
Leono	león	AST, NOM
Leporo	Liebre	AST
Lieĝo	Lieja	GEOG
Limburgo	Limburgo	GEOG
Linko	Lince	AST
Liro	Lira	AST
Loveno	Lovaina	GEOG
Ludoviko	Luis	NOM
Ludoviko	Ludovico	NOM
Luko	Lucas	NOM
Luksemburgio	Luxemburgo	GEOG
Luksemburgo	Luxemburgo	GEOG
Lutero	Lutero	KRI, PERS
Mahometo	Mahoma	
Majenco	Maguncia	GEOG
Malgranda Ursino	Osa Menor	AST
Marko	Marcos	NOM
Marso	Marte	AST, MIT
Mastriĥto	Maastricht	GEOG
Meduzo	Medusa	MIT
Merkuro	Mercurio	AST, MIT
Mezopotamio	Mesopotamia	GEOG, HIS
Mikroskopo	Microscópio	AST
Monda Organizaĵo pri Meteologio	Organización Metereológica Mundial	MET, SCI
Monda Organizaĵo pri Meteologio	OMM	MET, SCI
Monda Organizaĵo pri Sano	Organización Mundial de la Salud	MED
Monda Organizaĵo pri Sano	OMS	MED
Monda Organizaĵo pri Turismo	Organización Mundial del Turismo	POL
Monda Organizaĵo pri Turismo	OMT	POL
Mongolujo	Mongolia	GEOG
Moskvo	Moscú	GEOG
Mozo	Mosa	GEOG
Neptuno	Neptuno	AST, MIT
Neĝulino	Blanca Nieves	PERS
Nikolao	Nicolás	NOM
Nimego	Nimega	GEOG
Nord-Atlantika Traktat-Organizaĵo	Organización Tratado de Atlántico Norte	POL
Nord-Atlantika Traktat-Organizaĵo	OTAN	POL
Nov-Zelando	Nueva Zelanda	GEOG
Obo	Obi	GEOG
Oceanio	Oceanía	GEOG
Odiseado	Odisea	BELE, FIG
Odiseo	Ulises	NOM, PERS
Oriono	Orión	AST, MIT
Oriono	Cazador	AST, MIT
Oriono	Cazador del Cielo	AST, MIT
Ostendo	Ostende	GEOG
Pacifiko	océano Pacífico	GEOG
Paralimpiko	juegos paralímpicos	SPO
Pasiono	Pasión	KRI, MUZ
Paskalo	Pascal	KOMP, PERS
Pegazo	Pegaso	AST, MIT
Pesilo	Libra	AST
Pesilo	Balanza	AST
Platono	Platón	FIL, NOM, PERS
Plejadoj	Pléyades	AST
Plejadoj	Siete Cabritas	AST
Plejadoj	Siete Hermanas	AST
Pokalo	Copa	
Polio	Polonia	GEOG, POL
Pollando	Polonia	GEOG, POL
Polujo	Polonia	GEOG, POL
Pompejo	Pompeya	ARKE, GEOG
Pozidono	Poseidón	MIT
Rejnland-Palatinato	Renania-Palatinado	GEOG
Rejno	Rin	GEOG
Romio	Antigua Roma	HIS
Romo	Roma	GEOG, HIS
Rudolfo	Rodolfo	NOM
Sankta Manĝo	La última cena	BELA, KRI
Sankta Skribo	Santas Escrituras	REL
Sanskrito	sánscrito	LIN
Saturno	Saturno	AST, MIT
Sauda Arabujo	Arábia Saudita	EVI, GEOG
Saud-Arabujo	Arábia Saudita	EVI, GEOG
Savarmeo	Ejercito de Salvación	
Sergio	Sergio	NOM
Skeldo	Escalda	GEOG
Skitio	Escitia	GEOG, HIS
Sokrato	Sócrates	FIL, NOM, PERS
Sudameriko	Sudamérica	GEOG
Sumerio	Sumeria	GEOG
Sumerujo	Sumeria	GEOG
Svedio	Suecia	GEOG
Svedujo	Suecia	GEOG
Svisio	Suiza	GEOG
Tablomonto	Mesa	AST
Teodoro	Teodoro	NOM
Torao	Pentateuco	BIB, REL
Unikodo	Unicode	KOMP
Unikso	Unix	KOMP
Unuiĝintaj Nacioj	Naciones Unidas	POL
Unuiĝintaj Nacioj	ONU	POL
Uralo	Urales	GEOG
Uralo	Montes Urales	GEOG
Uralo	Ural	GEOG
Uralo	Río Ural	GEOG
Urano	Urano	AST, MIT
Urugvajo	Uruguay	GEOG
Usono	Estados Unidos de América	GEOG, POL
Usono	EE.UU.	GEOG, POL
Utreĥto	Utrecht	GEOG
Valonio	Valonia	GEOG
Valonujo	Valonia	GEOG
Varingjeno	Waringhien	ESP, PERS
Venuso	Venus	AST, MIT
Vergilio	Virgilio	NOM, PERS
Vezuvio	Vesubio	GEOG
Vindozo	Windows	KOMP
Virhidro	Hidra macho	AST
Volgo	Volga	GEOG
Zamenhofo	Zamenhof	PERS
Zelando	Zelanda	GEOG
Zeŭso	Zeus	MIT
a-vorto	adjetivo	GRA
abako	ábaco	ARKI, MAT
abasido	abasí	HIS
abasido	abasida	HIS
abato	abad	KAT
abdiki	abdicar	ARK
abdiki	dimitir	ARK
abdomeno	abdomen	ANA, ZOO
abela	de Abel	MAT
abela	abeliano	MAT
abelejo	colmenar	
abelejo	abejera	
abelisto	apicultor	
abelo	abeja	ZOO
abelreĝino	reina	ZOO
abelujo	colmena	
aberacio	aberración	AST, FIZ, FOT, MED, RAR, SCI
abio	abeto	BOT
abismo	abismo	FIG
abituriento	bachiller	PED
ablacio	ablación	AST, EKOL, GEOL, KIR, MED
ablativo	ablativo	GRA
abnegacio	abnegación	
aboco	abecedario	FIG
aboco	ABC	FIG
aboco	abecé	FIG
aboli	abolir	JUR
abolicii	abolir	JUR
abomena	abominable	
abomeni	abominar	
abomeninda	abominable	
aboni	estar abonado a	ARK, KOMP
aboni	estar suscrito a	ARK, KOMP
aboni	estar inscrito en	ARK, KOMP
aboni	suscribirse a	ARK, KOMP
abonigi	abonar	
abonilo	formulario de inscripción	
abonilo	hoja de suscripción	
abono	suscripción	
aborti	abortar	FIG, MED
abortigi	provocar un aborto	FIG, MED
abortigi	abortar	FIG, MED
aborto	aborto	MED
abrikoto	albaricoque	
abrikotujo	albaricoquero	BOT
abrikotarbo	albaricoquero	BOT
abrupta	abrupto	
absceso	absceso	MED
absciso	abscisa	MAT
absido	ábside	ARKI
absintaĵo	absenta	KUI
absinto	ajenjo	BOT
absolvi	absolver	JUR, KAT
absorbi	absorber	
absorbi	ocupar	
abstinado	abstinencia	
abstinenco	abstinencia	
abstini	abstener	KAT
absurda	absurdo	
abunda	abundante	
abundeco	abundancia	
abundi	abundar	
abutmento	contrafuerte	ARKI
acero	arce	BOT
acetato	acetato	KEM
acetileno	acetileno	KEM
aceto	ácido acetico	KEM
acetono	acetona	KEM
acida	ácido	FIG
acido	ácido	KEM
adapti	adaptar	FIG, TEK
adaptilo	adaptador	TEK
adaĝo	adagio	MUZ
adekvata	adecuado	FIL
adeptigi	reclutar	
adepto	adepto	
adhera	adhesivo	MAT
adheri	adherir	FIZ, MED, TEK
adheri	pegar	FIZ, MED, TEK
adhero	adherencia	
adiaŭ	adiós	
adiaŭdiri	decirle adiós a	
adiaŭdiri	despedirse de	
adiaŭi	decirle adiós a	KOMP
adiaŭi	despedirse de	KOMP
adiaŭi	cerrar sesión	KOMP
adiciato	sumando	MAT
adicii	sumar	MAT
adicio	suma	MAT
adjektivo	adjetivo	GRA
adjunkto	asistente	
administracio	administración	POL
administrantaro	administración	POL
administrejo	administración	POL
administri	administrar	POL
admiralo	almirante	MIL
admiri	admirar	
admitanco	admitancia	ELE, FIZ
admoni	exhortar	
adopti	adoptar	FIG
adori	adorar	
adresanto	remitente	
adresaro	directorio	
adresato	destinatario	
adresi	remitir	POSX
adreso	dirección	KOMP, POSX
adstringa	astringente	MED
adulti	cometer adulterio	
advento	Adviento	KRI
adverbo	adverbio	GRA
advokato	abogado	FIG, JUR
aera	aéreo	FIG
aero	aire	KEM
aerobia	aerobio	ZOO
aerodromo	aeródromo	AVI
aerodromo	aerodromo	AVI
aerofloto	flota aérea	AVI
aerolito	aerolito	AST
aerometro	aerómetro	FIZ
aeronaŭtiko	aeronáutica	AVI, SCI
aeronaŭto	aeronauta	AVI
aeroplano	aeroplano	ARK, AVI
aeroplano	avión	ARK, AVI
aerpumpilo	compresor	
aerumi	airear	
aerŝtono	aerolito	MET
afabla	amable	KOMP
afabla	amigable	KOMP
afazio	afasia	MED
afekcio	afección	FIL, MED, PSI
afekti	afectar	
afektiva	afectivo	
afelio	afelio	AST
afero	cosa	EKON, JUR
afero	asunto	EKON, JUR
afero	caso	EKON, JUR
afero	asunto	EKON, JUR
afikso	afijo	GRA
afina	afín	MAT
afiŝo	cartel	KOMP
afiŝo	póster	KOMP
afiŝo	pancarta	KOMP
afiŝo	mensaje	KOMP
aflikti	afligir	
afonio	afonía	MED
aforismo	aforismo	BELE
afranki	franquear (correos)	EKON
afrikano	africano	
afrikato	africada	FON
afto	afta	MED, ZOO
aftozo	fiebre aftosa	ZOO
agaci	dentera	
agapo	ágape	KRI
agato	ágata	MIN
agavo	agave	BOT
agendo	agenda	
agentejo	agencia	
agento	agente	
agi	actuar	
agiti	agitar	
agiti	agitar	
agleca	agileño	
aglo	águila	ZOO
aglomeri	aglomerar	
aglutina	aglutinante	LIN
aglutini	aglutinar	BIO, KEM, MED
agnato	agnado	JUR
agnoski	reconocer	
agnoski	admitir	
agnostikismo	agnosticismo	FIL
agonii	agonizar	FIG
agonio	agonía	
agorafobio	agorafobia	MED
agordi	afinar	FIG, MUZ, TEK
agrabla	agradable	
agresema	agresivo	
agresi	agredir	
agrikulturo	agricultura	
agro	agro	AGR
agronomio	agronomía	AGR
agroturismo	turismo rural	
aha	ajá!	
aidoso	sida	BAK, MED
aidosulo	sidoso	
aikido	aikido	SPO
ajatolo	ayatolá	ISL
ajgeno	eigenvalor	MAT
ajgeno	valor propio	MAT
ajlo	ajo	BOT, KUI
ajuto	boquilla	TEK
akademiano	académico	EVI
akademio	academia	EVI
akapari	acaparar	EKON
akaro	ácaro	ZOO
akaĵuarbo	anacardo	BOT
akaĵuujo	anacardo	BOT
akaĵunukso	nuez de caoba	KUI
akceli	acelerar	
akcelilo	acelerador	FIZ
akcelo	aceleración	FIZ
akcenti	acentuar	FON, KOMUNE
akcento	acento	FON
akcepti	aceptar	EKON
akcesora	accesorio	
akcesora	secundario	
akcidento	accidente	FIL
akcio	acción	EKON
akciulo	accionista	EKON
akiri	adquirir	EKON
aklami	aclamar	
akmeo	acmé	FIG, MED, RAR
akno	acné	
akolito	acólito	REL
akomodi	adaptar	
akomodi	acomodar	
akompanantaro	compañía	
akompani	acompañar	MUZ
akordiono	acerdeón	MUZ
akordo	acorde	GRA, JUR, MUZ
akordo	acuerdo	GRA, JUR, MUZ
akra	afilado	
akra	cortante	
akra	agudo	
akra	puntiagudo	
akra	agudo, -a	
akra	severo	
akra	penetrante	
akraĵo	filo	
akraĵo	bode u orilla	
akrediti	acreditar	EKON
akrigi	aguzar	
akrigi	afilar	
akrigilo	afilador	
akrigilo	piedra de afilar	
akro	acre	
akrobataĵo	acrobacia	FIG
akrobato	acróbata	
akromata	acromático	FOT
akropolo	acrópolis	ARKI
akrostiĥo	acróstico	POE
akselo	axila	ANA
aksiomo	axioma	FIG, FIL, MAT
akso	eje	FIG, MAT, POL, TEK
aktinio	actinio	KEM, ZOO
aktiniumo	actinio	KEM
aktiva	activo	GRA
aktivo	activo	EKON, GRA
aktivo	voz activa	EKON, GRA
akto	acto	JUR, TEA
akto	acta	JUR, TEA
aktoro	actor	KIN, TEA
aktuala	actual	KOMUNE, LIN, SCI
aktuala	vigente	KOMUNE, LIN, SCI
akumulatoro	acumulador	ELE
akumulatoro	acumulador	ELE
akupunkturisto	acupuntor	MED
akupunkturisto	acupunturista	MED
akupunkturo	acupuntura	MED
akurata	puntual	EVI
akurata	exacto	EVI
akustiko	acústica	FIZ, KIN, TEA
akuta	agudo	EVI, FON, MAT, MED, RAR
akuta	agudo	EVI, FON, MAT, MED, RAR
akuta	agudo	EVI, FON, MAT, MED, RAR
akuta	agudo	EVI, FON, MAT, MED, RAR
akuz(aĵ)o	acusación	
akuzativo	acusativo	GRA
akuzi	acusar	
akuŝi	parir	FIG
akuŝi	dar a luz	FIG
akuŝigistino	partera	
akuŝistino	partera	
akva	acuático	
akvaforto	agua fuerte	BELA
akvamarino	aguamarina	MIN
akvarelo	acuarela	BELA
akvario	acuario	
akvedukto	acueducto	
akvo	agua	
akvodukto	acueducto	ARKI, TEK
akvofalo	cascada	GEOG
akvokreso	berro	
akvomelono	sandía	KUI
akĉento	acento	FON, LIN
alabastro	alabastro	MIN
alarmilo	alarma	
alarmo	alarma	
albatroso	albatros	ZOO
albino	albino	
albumino	albúmina	MED
albumo	álbum	MUZ, TIP
aldehido	aldehído	KEM
aldoni	agregar	
aldonvalora imposto	impuesto sobre el valor añadido	EKON
aldonvalora imposto	impuesto al valor agregado	EKON
aldonvalora imposto	IVA	EKON
alegoria	alegórico	
alegorio	alegoría	BELE
aleo	alameda	HOR, TRA
alerono	alerón	AVI
alfabeto	alfabeto	
alfenido	alfenide	KEM
algebra frakcio	fracción algebráica	MAT
algoritmo	algoritmo	KOMP, MAT
alia	otro	
alianco	alianza	POL
alibio	coartada	
aligatoro	aligátor	ZOO
alimento	alimentos	EKON
alineo	párrafo	ARK, TIP
alineo	sangría	ARK, TIP
aliteracio	aliteración	POE
alivesti	travestir	
alkado	alcaide	HIS, JUR
alkal(ec)a	alcalino	
alkaloido	alcaloide	KEM
alkazaro	alcázar	ARKI
alklimatiĝi	aclimatarse	
alko	alce	ZOO
alkoholigi	alcoholizar	
alkoholismo	alcoholismo	MED
alkoholo	alcohol	KEM
alkovo	alcoba	
almanako	almanaque	
almanaĥo	almanaque	RAR
almenaŭ	al menos	
almozdonema	caritativo	EKON
almozdoni	dar limosna	
almozi	limosnar	
almozi	pedir limosna	
almozi	mendigar	
almozpeti	limosnar	
almozpeti	pedir limosna	
almozpeti	mendigar	
almozisto	limosnero	
almozisto	pordiosero	
almozisto	mendigo	
almozo	limosna	
almozulo	limosnero	
almozulo	pordiosero	
almozulo	mendigo	
alo	ala	
aloji	alear	KEM
alojo	aleación	KEM
alopatio	alopatía	MED
alopecio	calvicie	MED
alopecio	alopecia	MED
alozo	alosa	ZOO
alpako	alpaca	TEKS, ZOO
alparo	paridad	EKON
alparo	valor nominal	EKON
alta	alto	FIG, MUZ
alta frekvenco	alta frecuencia	ELE, FIZ, TEK
altaro	altar	FIG, KRI, REL
alteco	altura	
alteco	altitud	
alteriĝi	aterrizar	
alterna kurento	corriente alterna	ELE
alternanco	semiperiodo	ELE, FIZ
alternanco	semiperíodo	ELE, FIZ
alternativo	alternativo	
alternatoro	alternador	ELE
alterni	alternar	
altmaro	marea alta	MAR
alto	altura	MAT
altrudi	imponer	
altruismo	altruismo	FIL
altruisto	altruista	
altvalora	valioso	
aludi	aludir	
alumeto	cerillo	
alumeto	cerilla	
alumeto	fósforo	
aluminio	aluminio	KEM
alumino	alúmina	KEM
aluno	alumbre	
aluvio	aluvión	ARK, GEOL
alĝebro	álgebra lineal	EVI, MAT
alĥemiisto	alquimista	
alĥemio	alquimia	
alŝtatigo	nacionalización	POL
alŝuti	subir	KOMP
alŝuti	cargar	KOMP
amalgamo	amalgama	
amant(in)o	amante	
amara	amargo	
amaranto	amaranto	BOT
amasbuĉi	masacre	
amasigi	amasar	
amaso	masa	
amazono	amazona	FIG, MIT
ambasadejo	embajada	
ambasado	embajada	POL
ambasadorejo	embajada	
ambasadoro	embajador	POL
ambaŭ	ambos	
ambaŭdirekta implikacio	equivalencia	MAT
ambicia	ambicioso	
ambicio	ambición	
ambigua	ambiguo	BELE, LIN, RAR
ambigueco	ambigüedad	RAR
ambiguo	ambigüedad	RAR
ambono	ambón	ARKI, REL
amboso	yunque	ANA
ambrozio	ambrosía	MIT
ambulanco	ambulancia	MIL
amdeklaro	declaración de amor	
amebo	amiba	ZOO
amen	amén	REL
amendo	enmienda	JUR
americio	americio	KEM
amerika	americano	
amerikano	americano	
ametisto	amatista	MIN
amfibrako	anfíbraco	POE
amfiteatro	anfiteatro	ARKI, TEA
amforo	ánfora	ARKE
ami	amar	
amika	amistoso	
amikeco	amistad	
amiki	ser amigo	
amikino	amiga	
amikiĝi	hacer amistad	
amikiĝi	trabar amistad	
amikiĝi	hacerse amigo	
amiko	amigo	
aminda	amable	
amindumi	cortejar	
amnestio	amnistía	JUR
amnezio	amnesia	MED
amo	amor	
amoniako	amoniaco	KEM
amonito	amonites	MIN
amorant(in)o	amante	
amorfa	amorfo	KEM
amori	hacer el amor	
amoro	amor	BELA
amoro	relación sexual	BELA
amortizi	amortizar	AUT, EKON, ELE, FER, FIZ
amortizi	amortiguar	AUT, EKON, ELE, FER, FIZ
amortizilo	amortiguador	AUT, FER, FIZ
amovendistino	prostituta	
ampermetro	amperímetro	ELE, FIZ
amplifi	amplificar	
amplifikatoro	amplificador	ELE
amplifilo	amplificador	
amplitudo	amplitud	ELE
ampolingo	casquillo	ELE
ampolo	ampolla	ELE
ampolo	bombilla	ELE
amputi	amputar	KIR
amuleto	amuleto	
amuzi	entretener	
amuzi	divertir	
amuzparko	parc d'atraccions	
anagramo	anagrama	
anakronismo	anacronismo	
analfabeto	analfabeto	
analitika geometrio	geometría analítica	MAT
analitiko	analítica	MAT
analizi	analizar	
analo	anal	RAR
analoga	análogo	TEK
analoga	analógico	TEK
analogia	análogo	
analogia	analógico	
analogio	analogía	
ananaso	piña	
ananasujo	ananás	BOT
anarkia	anarquista	KOMUNE
anarkiisto	anarquista	
anarkio	anarquía	KOMUNE, POL
anarkismo	anarquismo	EVI
anarkisto	anarquista	EVI
anarkiulo	anarquista	KOMUNE
anarĥia	anarquista	
anarĥiisto	anarquista	
anarĥio	anarquía	
anarĥiulo	anarquista	
anaso	pato	KOMUNE, ZOO
anastigmata	anastigmático	FOT
anatomio	anatomía	ANA, SCI
andante	andante	
andanto	andante	MUZ
androgina	andrógino	BOT
anekdoto	anécdota	
aneksaĵo	anexo	
aneksi	anexar	POL
anelidoj	anélidos	ZOO
anemio	anemia	MED
anemometro	anemómetro	FIZ, MET
anestezi	anestesiar	MED
anestezilo	anestesia	
angilo	anguila	ZOO
angino	angina	MED
angio	vaso	ANA, BOT
angla	inglés	
anglo	inglés	
angoro	angustia	
angulmezurilo	transportador	MAT, TEK
angulo	ángulo	FIG, MAT
anheli	jadear	
anheli	hiperventilar	
anheli	anhelar	
anihilacii	aniquilar	FIZ
anihilacio	aniquilación	FIZ
anilino	anilina	KEM
animacio	animación	KOMP
animalo	animal	BIO, EVI
animi	animar	
animo	alma	FIG, FIL, REL
anizo	anís	KUI
ankaŭ	también	
ankoraŭ	todavía	
ankri	anclar	MAR
ankro	ancla	AVI, MAR
anksia	ansioso	
anksio	ansiedad	PSI
anodo	ánodo	ELE
anomalio	anomalía	
anonci	anunciar	
anonco	anuncio	
anonima	anónimo	
anono	anona	KUI
anono	cherimoya	KUI
anormala	anormal	
ansero	ganso	AGR, FIG, ZOO
anso	asa	EVI
anstataŭa	sustituto	
anstataŭa	de recambio	
anstataŭa	suplente	
anstataŭe	en cambio	
anstataŭe	en su lugar	
anstataŭi	sustituir	
anstataŭi	cambiar	
anstataŭi	reemplazar	
anstataŭigi	sustituir	
anstataŭilo	sustituto	
anstataŭo	sustituto	RAR
anstataŭo	reemplazo	RAR
anstataŭo	sustitución	RAR
anstataŭulo	sustituto	RAR
antagonismo	antagonismo	
antagonisto	antagonista	
antarkta	antártico	GEOG
antaŭ	ante	
antaŭ	ante	
antaŭ	antes de	
antaŭdifini	predefinir	
antaŭgvardio	vanguardia	MIL
antaŭhieraŭ	anteayer	
antaŭhieraŭ	antes de ayer	
antaŭjuĝi	prejuicio	
antaŭnelonge	hace poco	
antaŭ nelonge	hace poco	
antaŭparolo	prólogo	BELE
antaŭparolo	prefacio	BELE
antaŭvidi	prever	
anteno	antena	ELE, MAR, ZOO
anteno	antena	ELE, MAR, ZOO
antero	antera	BOT
antibiotiko	antibiótico	BIO, MED
anticipi	anticipar	
antidoto	antídoto	MED
antifono	antífona	MUZ
antifrazo	antífrasis	BELE, LIN
antikrezo	anticresis	EKON
antikristo	anticristo	KRI
antikva	antiguo	
antikvaĵo	antigüedad	
antikveco	antigüedad	
antilopo	antílope	ZOO
antimono	antimonio	KEM
antipatio	antipatía	
antipirino	antipirina	MED
antipodo	antípoda	
antisemito	antisemita	
antisepsa	antiséptico	
antisepso	antisepsia	MED
antitezo	antítesis	
antologio	antología	BELA, TIP
antonimo	antónimo	GRA
antracito	antracita	MIN
antrakso	ántrax	MED
antrakso	carbunco	MED
antrakso	ántrax maligno	MED
antropoida	antropoide	ZOO
antropologiisto	antropólogo	
antropologio	antropología	SCI
antropometrio	antropometría	
antropomorfismo	antropomorfismo	FIL
anuitato	anualidad	EKON
anunciacio	Anunciación	KRI
anuso	ano	ANA
anĉovo	anchoa	KUI, ZOO
anĝelo	ángel	REL
aorto	aorta	ANA
aparato	aparato	BIB, BIO, POL, TEK, TIP
apartamento	aparamiento	
apartenaĵo	pertenencia	EKON
aparteni	pertenecer	EKON, MAT
apatio	apatía	
apatito	apatita	MIN
apaĉa	apache	
apaĉo	apache	POL
apelacii	apelar	EKON, FIG, JUR
apenaŭ	apenas	
apendicito	apendicitis	MED
apendico	apéndice	ANA, TIP
apepsio	apepsia	MED
aper(aĵ)o	aparición	KOMP, MAT
aperi	aparecer	TIP
aperi	parecer	TIP
aperi	aparecer	TIP
aperi	aparecer	TIP
aperitivo	aperitivo	KUI
aperta	abierto	
apertigi	abrir	RAR
aperturo	abertura	
apetito	apetito	
apetitveka	apetitoso	FIG
apio	apio	BOT
aplaŭdi	aplaudir	FIG
apliki	aplicar	
aplombo	aplomo	
apofizo	apófisis	ANA
apogeo	apogéo	AST, FIG
apogi	apoyar	FIG
apogilo	apoyo	
apokalipsa	apocalipsis	FIG
apokopo	apócope	GRA
apokrifa	apócrifa	
apopleksio	apoplegía	MED
apostato	apóstata	
aposteriora	a posteriori	
apostolo	apóstol	FIG, KRI
apostrofo	apóstrofe	
apoteko	farmacia	MED
apozicii	poner en aposición	
apozicio	aposición	GRA
apoĝaturo	apoyatura	MUZ
aprezi	apreciar	
aprilo	abril	
apriora	a priori	FIL, KOMP, KOMUNE
apriora	a priori	FIL, KOMP, KOMUNE
apriora	a priori	FIL, KOMP, KOMUNE
apro	jabalí	ZOO
aprobi	aprobar	
aprobo	aprobación	
aproksimi	aproximar	MAT
apsido	ápside	AST
araba	árabe	
araba	arábigo	
arabeca	arabesco, -a	
arabesko	arabesco	
arabo	árabe	
arakido	cacahuate	BOT
araneo	araña	ZOO
arbalesto	ballesta	
arbaro	bosque	GEOG, HOR
arbitra	arbitrario	
arbitracii	arbitrar	
arbitracio	arbitraje	EKON, JUR
arbitro	arbitrariedad	
arbo	árbol	BOT, HOR, KOMP, MAT
arbohakisto	leñador	HOR
arbusto	arbusto	BOT
arbuto	madroño	BOT
arbutujo	madroño	
arda	ardiente	FIG
ardezo	pizarra	MIN
ardi	arder	FIG
areno	arena	ARKI, FIG, SPO
areno	arena	ARKI, FIG, SPO
areno	campo	ARKI, FIG, SPO
areno	plaza	ARKI, FIG, SPO
areo	área	FIZ, MAT
areo	superficie	FIZ, MAT
areometro	aerómetro	
aresti	arrestar	JUR
aresto	arresto	
argono	argón	KEM
argumenti	argumentar	
argumento	argumento	MAT
arida	árido	GEOG
ario	aria	MUZ
aristokratio	aristocracia	POL
aristokrato	aristócrata	
aritmetika	aritmético	MAT
aritmetiko	aritmética	MAT
arkaika	arcáico	
arkaismo	arcaísmo	
arkeo	arca (de Noé)	BIB
arkeologiisto	arqueólogo	ARKE
arkeologio	arqueología	ARKE, SCI
arkeologo	arqueólogo	
arkeopteriko	arqueopteryx	PAL, ZOO
arkiduko	archiduque	
arkipelago	archipiélago	GEOG
arkitekto	arquitecto	
arkitekturisto	arquitecto	ARKI
arkitekturo	arquitectura	ARKI, BELA
arkitravo	arquitrabe	ARKI
arkivejo	archivo	
arkivisto	archivista	
arkivo	archivo	
arko	arco	ELE, EVI, MAT
arlekeno	arlequín	TEA
armaturi	armadura	
armeo	ejército	FIG, MIL, POL
armeo	armada	FIG, MIL, POL
armilaro	armamento	FIG
armilo	arma	FIG
armo	arma	ARK
arniko	árnica	BOT
aro	área	MAT
arobo	arroba	
aroganta	arrogante	
arogi	arrogar	
aroki	enrocar	SPO
aromi	oler	
aromigi	aromatizar	
aromo	aroma	
aromo	olor	
arpeĝi	arpegiar	
arpeĝo	arpegio	MUZ
arsenalo	arsenal	FIG, MIL
arseniko	arsénico	EVI, KEM
arseno	arsénico	KEM
artefarita intelekto	inteligencia artificial	KOMP
arterio	arteria	ANA, FIG
arteza	artesiano	
artik(ig)i	articular	ARK, FON
artikiga punkto	punto de articulación	ARK, FON
artiklo	artículo	EKON
artiko	articulación	ANA, TEK
artikolo	artículo	GRA
artikpieduloj	artrópodos	ZOO
artikulacia	articulación	FON
artikulacii	articular	FON
artileriano	artillero	
artileriisto	artillero	
artilerio	artillería	
artrito	artritis	MED
arĝenta	de plata	
arĝenta	plateado	
arĝentisto	platero	
arĝento	plata	KEM
arĥaika	arcáico	
arĥitekto	arquitecto	
arĥitekturisto	arquitecto	
arĥitekturo	arquitectura	
arĥivejo	archivo	
arĥivisto	archivista	
arĥivo	archivo	
asafetido	asa fétida	MED
asbesto	asbesto	MIN, TEK, TEKS
asekuri	asegurar	EKON, FIG
asekuro	seguro	EKON
asembleo	asamblea	JUR
asepso	asepsia	MED
aserti	afirmar	
asesoro	asesoría	JUR
asfalti	asfaltar	
asfalto	asfalto	TRA
asfiksii	asfixiar	
asfiksio	asfixia	
asigni	asignar	EKON, JUR
asimili	asimilar	BIO, FIG, LIN, POL
asimili	asimilar	BIO, FIG, LIN, POL
asimptoto	asíntota	MAT
asketismo	ascetismo	
asketo	asceta	
aso	as	HIS, SPO
asocii	asociar	
asocio	asociación	
asparago	espárrago	BOT
aspekte	en apariencia	
aspekte	aparentemente	
aspekti	tener aspecto	
aspekti	parencer	
aspekti	tener aire	
aspekto	aspecto	
aspekto	apariencia	
aspiri	aspirar a	
aspirino	aspirina	MED
aspra	áspero	FIG, RAR
astateno	ástato	KEM
astato	ástato	KEM
astenio	astenia	MED
asterio	estrella de mar	ZOO
asterisko	asterisco	TIP
asteroido	asteroide	AST
astigmata	astigmático	
astigmateco	astigmatismo	FOT
astigmatismo	astigmatismo	MED
astmo	asma	MED
astrakano	astracán	
astro	astro	AST, EVI
astrofiziko	astrofísica	AST, FIZ, SCI
astrolabo	astrolabio	AST
astrologiisto	astrólogo	
astrologio	astrología	
astrologo	astrólogo	
astronomiisto	astrónomo	AST
astronomio	astronomía	AST, SCI
astronomo	astrónomo	AST
ataki	atacar	
atavismo	atavismo	GEN
ateismano	ateo	
ateismo	ateismo	FIL
ateisto	ateo	REL
atendejo	sala de espera	
atendi	esperar	
atenta	atento	
atesti	atestiguar	JUR
atesti	testificar	JUR
atesto	testimonio	
atingi	conseguir	FIG
atingi	lograr	FIG
atingo	logro	KOMP
atlaso	atlas	ANA, FIG, GEOG, MIT, TEKS
atletismo	atletismo	SPO
atleto	atleta	FIG, SPO
atmosfero	atmósfera	AST, FIG, FIZ, MET
atolo	atolón	GEOG
atomo	átomo	FIZ, KEM
atonio	atonía	MED
atrakcio	atracción	TEA
atrepsio	atrepsia	MED
atribui	atribuir	
atributo	atributo	BELA, EVI, FIL, KOMP
atrofiigi	atrofiar	
atrofiiĝi	atrofiarse	
atrofio	atrofia	MED
atropino	atropina	KEM
avalo	aval	EKON
avanci	avanzar	RAR
avanci	avanzar	RAR
avanci	anticipar	RAR
avangardo	vanguardia	FIG, MIL
avantaĝa	ventajoso	
avantaĝo	ventaja	
avara	avaro	FIG
avelo	avellana	
aveno	avena	AGR, BOT
aventuro	aventura	
avenuo	avenida	TRA
averii	averiarse	
averio	avería	EKON
averti	advertir	
aviadi	volar	AVI
aviadilo	avión	AVI
aviadisto	aviador	
aviadisto	piloto	
aviado	aviación	AVI
avida	ávido	
avino	abuela	GEN
avio	avión	AVI
aviso	aviso	MAR
avizi	avisar	
avizo	aviso	EKON, KOMUNE
avizo	anuncio	EKON, KOMUNE
avo	abuelo	GEN
azaleo	azalea	BOT
azaro	ásaro	BOT
azeno	asno	FIG, ZOO
azeno	burro	FIG, ZOO
aziano	asiático	
azilo	asilo	
azilo	refugio	
azimuto	acimut	AST
azimuto	azimut	AST
azotacido	ácido nítrico	KEM
azoto	nitrógeno	KEM, SCI, TEK
azteka	azteca	
azteko	azteca	HIS
azuleĥo	azulejo	ARKI, BELA
aĉetanto	comprador	
aĉetebla	disponible	
aĉetebla	en venta	
aĉetebla	comprable	
aĉeti	comprar	
aĝo	edad	
aĵgenro	género inanimado, género neutro	GRA
neŭtra genro	género inanimado, género neutro	GRA
aĵura	calado	
aŭ	o	
aŭdaca	audaz	
aŭdaco	audacia	
aŭdi	oír	
aŭdienco	audiencia	
aŭditorio	auditorio	
aŭguri	augurio	
aŭguro	augurio	HIS
aŭgusto	agosto	KAL
aŭkcii	subastar	EKON
aŭkciisto	subastar	EKON
aŭkcio	subasta	EKON
aŭreolo	aureola	BELA, FIG, REL
aŭriklo	aurícula	ANA
aŭrori	amanecer	
aŭroro	aurora	AST, FIG, KAL
aŭskulti	escuchar	FIG
aŭtarcio	autarquía	EKON
aŭtarkia	autarquía	
aŭtenta	auténtico	
aŭtenteco	autenticidad	
aŭtentigi	autentificar	
aŭtentika	auténtico	EVI
aŭtentikeco	autenticidad	
aŭtentikigi	autentificar	
aŭtismo	autismo	MED
aŭtisto	automovilista	
aŭto	auto	AUT, TRA
aŭto	coche	AUT, TRA
aŭtobiografio	autobiografía	BELE
aŭtobuso	autobús	AUT
aŭtobuso	camión	AUT
aŭtodidakto	autodidacta	PED
aŭtogiro	autogiro	AVI
aŭtografio	autografía	TEK
aŭtografo	autógrafo	
aŭtokratio	autocracia	
aŭtokratismo	autocracia	
aŭtokrato	autócrata	
aŭtomacio	automación	EKON
aŭtomacio	automatización	EKON
aŭtomata	automático	FIG
aŭtomate	automáticamente	
aŭtomato	autómata	KOMP, MAT, TEK
aŭtomobilisto	automovilista	
aŭtomobilo	automóvil	AUT
aŭtonomio	autonomía	
aŭtopsio	autopsia	MED
aŭtopsio	necropsia	MED
aŭtoritata	autoritario	
aŭtoritato	autoridad	
aŭtoro	autor	
aŭtuno	otoño	FIG, KAL
babili	platicar	
babordo	babor	MAR
bacilo	bacilo	BIO
bagateli	ser una bagatela	
bagateligi	trivializar	
bagatelo	bagatela	
bagatelo	trivialidad	
bajoneto	bayoneta	MIL
bajto	byte	KOMP
bakalaŭro	bachiller	PED
bakanalo	bacanal	
bakelito	baquelita	KEM
baki	hornear	FIG, KUI, TEK
bakterio	bacteria	BAK
balado	balada	POE
balai	barrer	FIG
balailo	escoba	
balanci	balancear	
balanciĝi	balancearse	
balboo	balboa	EKON
balbuti	balbucear	MED
baldaŭ	pronto	
balenedoj	balénidos	ZOO
baleno	ballena	KOMUNE, ZOO
baleto	ballet	BELA
balgo	fuelle	TEK
balistiko	balística	FIZ, MIL, TEK
balisto	catapulta	MIL
balkono	balcón	
balo	baile	
balono	balón	AVI, KEM, SPO
balono	globo	AVI, KEM, SPO
balotado		
balotado	elección	
balotado	las elecciones	
balotejo	centro de votación	
baloti	votar	
baloti	elegir	
baloti	votar	
balotilo	instrumento de votación	
balotilo	papeleta de votación	
baloto	las elecciones	
balotrajto	derecho al sufragio	
balotujo	Urna	
balta-slava	baltoeslavo	LIN
balto	balto	HIS
balustrado	barandilla	ARKI
balustrado	baranda	ARKI
balzami	embalsamar	
balzamo	bálsamo	FIG, MED
bambuo	bambú	BOT
banala	banal	
banano	banana	
banano	plátano	
bandito	bandido	
bando	banda	MUZ
bandonio	bandoneón	MUZ
bandurio	bandurria	
banejo	baño	
banejo	cuarto de baño	
bani	bañar	FIG, TEK
baniĝi	bañarse	
bankedo	banquete	
bankestro	banquero	EKON
bankiero	banquero	EKON
banko	banco	EKON, FIG
bano	baño	
bantuko	toalla	TEKS
banujo	bañera	
banurbo	balneario	
banloko	balneario	
baobabo	baobab	BOT
bapti	bautizar	FIG, KRI
bapto	bautizo	
baptofilo	ahijado	
baptopatrino	madrina	
baptopatro	padrino	
barako	barraca	
barba	barbado, -a	
barba	barbudo, -a	
barbara	bárbaro	
barbaraĵo	barbaridad	
barbareco	barbaridad	
barbarismo	barbarismo	EVI, GRA
barbarismo	barbarismo	EVI, GRA
barbarismo	barbaridad	EVI, GRA
barbaro	bárbaro	FIG
barbaĵo	barba	
barbhava	barbado, -a	
barbhava	barbudo, -a	
barbiro	barbero	
barbisto	barbero	
barbo	barba	ANA
barbulo	barbudo	
bardo	bardo	HIS, POE
bareliefo	bajo relieve	BELA
barelo	barril	
baremo	baremo	
barikado	barricada	
bario	bario	KEM
baritono	barítono	MUZ
baritonulo	barítono	MUZ
barjono	barión	FIZ
barkarolo	barcarola	MUZ
baroka	barroco	
baroko	barroco	ARKI, BELA, BELE, MUZ
barometro	barómetro	FIZ, MET
barono	barón	
basa	bajo	
basisto	bajista	MUZ
baso	bajo	MUZ
bastardo	bastardo	GEN
bastiono	bastión	FIG, MIL
bastono	bastón	
basulo	bajo	MUZ
batali	combatir	
bataliono	batallón	MIL
batalo	batalla	
batalo	combate	
batato	batata	BOT
baterio	batería	ELE, MIL
batisto	batista	TEKS
batmakulo	hematoma	MED
batmakulo	cardenal	MED
batmakulo	moratón	MED
batmakulo	moretón	MED
batmakulo	equimosis	MED
batui	hacer una batida	
batuo	batida	
bavara	bávaro	
bavaro	bávaro	
bavaro	bávaro	
bazalto	basalto	MIN
bazaro	bazar	EKON
bazaro	mercado	EKON
bazaro	tienda por departamento	EKON
bazaro	almacén por departamento	EKON
baziliko	basílica	ARKI, HIS, KAT
bazo	base	FIG, KEM, KOMP, MAT
baŭdo	baudio	TEL
beata	beato	KAT
bebo	bebé	
bedaŭri	sentir	
bedaŭri	lamentar	
bedaŭrinde	desgraciadamente	
bedaŭrinde	lamentablemente	
bedueno	beduino	
begonio	begonia	BOT
bela	bonito	
bela	bello	
bela	hermoso	
beladono	belladona	BOT
belega	precioso	
beleta	lindo	
beletro	letras	BELE
belga	belga	
belgo	belga	
bemolo	bemol	MUZ
bendo	banda	
benefico	función benéfica	
beni	bendecir	FIG
benko	banca	
benko	banco	
benko	asiento	
beno	bendición	FIG
benzeno	benzeno	KEM
benzino	bencina	KEM
bergamoto	bergamota	BOT
beribero	beriberi	MED
berilio	berilio	KEM
berilo	berilo	MIN
berkelio	berquelio	KEM
bero	baya	BOT, KOMUNE
berserko	berserk	HIS
besto	animal	ARK, BIO, FIG, KOMUNE
betono	hormigón	KON
bezoaro	bezoar	FIZL
bezoaro	bezoard	FIZL
bezona	necesario	
bezonaĵo	necesidad	
bezoni	necesitar	
bezono	necesidad	
bibliografio	bibliografía	
bibliografo	bibliógrafo	
biblioteko	biblioteca	EVI, FIG, KOMP
bicikli	andar en bicicleta	
biciklo	bicicleta	
bienetato	catastro	JUR, RAR
bieno	terreno	AGR, EKON, FIG, POL
bieno	bien raíz	AGR, EKON, FIG, POL
bieno	bien	AGR, EKON, FIG, POL
bieno	propiedad	AGR, EKON, FIG, POL
biero	cerveza	KUI
bifsteko	bistec	
bigamio	bigamia	JUR
bigamiulo	bígamo	
bijekcia	biyectiva	MAT
bijekcio	biyección	MAT
bijekcio	función biyectiva	MAT
bilanco	balance	EKON, FIG
bilardejo	billar	
bilardo	billar	
bilardo	mesa de billar	
bildigo	función	MAT
bildo	imagen	MAT
bileto	boleto	EKON
bileto	billete	EKON
biliono	billón	EVI
bindi	encuadernar	KOMP, TIP
bingo	bingo	SPO
binoklo	gemelos	FOT
binoklo	prismáticos	FOT
binoklo	binoculares	FOT
binomo	binomio	MAT
biografio	biografía	BELE
biografo	biógrafo	
biologiisto	biólogo	BIO, SCI
biologio	biología	BIO, SCI
biologo	biólogo	
bioĥemiisto	bioquímico	
bioĥemio	bioquímica	BIO, SCI
biplano	biplano	AVI
birdo	pájaro	FIG, ZOO
birdoj	aves	ZOO
bisekcanto	bisectriz	MAT
bismuto	bismuto	KEM
bisturio	bisturí	MED
bito	bit	KOMP, MAR
bitoko	octeto	KOMP
blanka	blanco	
blanketo	firma en blanco	EKON, JUR
blankigi	blanquear	
blanko	blanco	
blankulo	blanco	
blasfemo	blasfemia	
blato	cucaracha	ELE, KOMP, ZOO
blato	cucaracha	ELE, KOMP, ZOO
blato	circuito integrado	ELE, KOMP, ZOO
blazono	blasón	HER
blendi	blindar	
blendo	blindaje	KEM, MIL, MIN
blenoragio	blenorragia	MED
blenoreo	blenorrea	MED
blinda	ciego	FIG
blinde	ciegamente	
blindigi	cegar	FIG
blokado	bloquéo	
bloko	bloque	KOMP, TEK
blonda	rubio	FIG
blovharmoniko	hermónica	MUZ
blovi	soplar	
blovinstrumento	instrumento de viento	MUZ
blua	azul	
blua	celeste	
bluso	blues	MUZ
bluzo	blusa	TEKS
bo-	político	
boao	boa	TEKS, ZOO
boardi	bordear	MAR
boardi	dar bordadas	MAR
bobeno	bobina	ELE
bofilino	nuera	GEN
bofilo	yerno	GEN
bofratino	cuñada	GEN
bofratino	cuñada	GEN
bofratino	cuñada	GEN
bofratino	concuña	GEN
bofrato	cuñado	GEN
bofrato	cuñado	GEN
bofrato	cuñado	GEN
bofrato	concuño	GEN
boji	ladrar	FIG
boksi	boxear	SPO
bokso	boxeo	SPO
bokso	box	SPO
bokso	pugilismo	SPO
boli	hervir	FIG
bolido	bólido	AST
boligi	hervir	
bolti	atornillar	TEK
boltingo	tuerca	TEK
bolto	tornillo	TEK
bolŝeviko	bolchevique	
bolŝevisto	bolchevique	
bombardi	bombardear	FIG, MIL
bombo	bomba	MIL
bombono	bonboón	KUI
bona	bueno	
bonedukiteco	buena educación	
bonfido	buena fe	
bonodorfumaĵo	incienso	
bonodori	oler bien	
bonvenigi	dar la bienvenida	
bonzo	bonzo	
borakso	bórax	KEM
boraparato	taladro	TEK
boraparato	taladradora	TEK
boraparato	perforadora	TEK
bordelo	burdel	
bordo	costa	GEOG
bori	horadar	
bori	taladrar	
borilo	barrena	TEK
borilo	barreno	TEK
borilo	broca	TEK
boro	boro	KEM
borso	bolsa de valores	EKON
bosono	bosón	FIZ
botanikisto	botánico	
botaniko	botánica	BOT, SCI
botelo	botella	
bovaĵo	carne de res	KUI
bovido	becerro	
bovino	vaca	AGR
bovo	res	AGR, ZOO
braceleto	brazalete	
brakicefalo	braquicéfalo	ANA
brako	brazo	ANA, FIG
brakringo	pulsera	
brakteo	bráctea	BOT
brakumi	abrazar	
brando	brandy	KUI
branko	branquia	ZOO
brano	salvado	
branĉo	rama	BOT, FIG
braĝo	brasa	
braĝujo	brasero	
bredi	criar	AGR
bremsi	frenar	FIG
bremso	freno	AUT, FER
breĉo	brecha	
brido	brida	
brido	rienda	
brigado	brigada	FIG, MIL
briko	ladrillo	KON
brila	brillante	
brili	brillar	FIG
brilianto	brillante	MIN
brilo	brillo	
brita	británico	
brito	británico	HIS
bromo	bromo	KEM
bronkito	bronquitis	MED
bronza	de bronce	
bronzo	bronce	KEM
brosi	cepillar	
broso	cepillo	
brovo	ceja	ANA
broĉo	broche	
brulego	incendio	
bruli	quemarse	FIG
bruna	café	
bruo	ruido	FIG
brustaĵo	pechuga	KUI
brusto	pecho	ANA
bubalo	búfalo	ZOO
budhismo	budismo	
budhisto	budista	
budhano	budista	
budho	Buda	
budo	kiosko	ARKI
budo	puesto	ARKI
budo	caseta	ARKI
budĝeto	presupuesto	
bufedo	buffet	
bufo	sapo	ZOO
bufro	tope	FER, KOMP, TEK
bufro	búfer	FER, KOMP, TEK
bukceno	bocina	MUZ
bukedo	ramo	FIG
buklo	bucle	MAT
bukoliko	bucólico	POE
bukoliko	égloga	POE
buldogo	bulldog	ZOO
buldozo	bulldozer	
bulea	booleano	
buleno	bolina	MAR
buleo	bula	KAT
bulgara	búlgaro	HIS, KOMUNE
bulgaro	búlgaro	HIS, KOMUNE
bulko	panecillo	KUI
bulo	bola	
bulteno	boletín	TIP
bulvardo	bulevar	TRA
bum	bum	
bumerango	boomerang	FIG
bunrako	Bunraju	TEA
buo	boya	MAR
burdo	abejorro	ZOO
burokrataro	burocracia	POL
burokrato	burócrata	POL
burso	cartera	
burso	monedero	
burĝo	burgués	
buso	camión	AUT
buso	autobús	AUT
busto	busto	BELA
butero	mantequilla	KUI
butiko	tienda	EKON
butikumi	ir de compras	
butoni	abotonar	
butono	botón	BOT, TEK, TEKS
butonumi	abotonar	
buĉejo	rastro	FIG
buĉi	sacrificar	FIG
buĉi	masacrar	FIG
buĝeto	presupuesto	EKON
buĝeto	presupuesto	EKON
buŝa	bucal	FON
buŝa	oral	FON
buŝa	oral	FON
buŝharmoniko	harmónica	MUZ
buŝo	boca	ANA, FIG
buŝtuko	servilleta	TEKS
caro	zar	POL
cedi	ceder	
cedro	cedro	BOT
cefalopodoj	cefalópodos	ZOO
cekumo	intestino ciego	ANA
cekumo	ciego	ANA
cele al	con el objetivo de	
celebri	celebrar	
celerio	apio	BOT
celi	apuntar	FIG
celilo	visor	
celilo	mirilla	
celo	objetivo	
celofano	celofán	KEM
celuloido	celuloide	KEM
celulozo	celuluza	KEM
cemento	cemento	ANA, TEK
cendo	centavo	EKON
cent	cien	
centavo	centavo	EKON
centaŭro	centauro	MIT
centezimala	centesimal	
centiaro	centiárea	
centigramo	centigramo	
centilitro	centilitro	
centimetro	centímetro	
centimo	céntimo	EKON
centralizi	centralizar	
centralo	central	ELE, TEL
centrifuga	centífuga	BOT, FIZ
centripeta	centrípeta	BOT, FIZ
centro	centro	MAT, POL
centuma	centesimal	
cenzuri	censura	
cepo	cebolla	BOT
ceramikaĵo	cerámica	
ceramiko	cerámica	
cerbaĵo	sesos	KUI
cerbo	cerebro	ANA, FIG
cerbujo	cráneo	
cerbumi	reflexionar	
cerealo	cereal	AGR
ceremonio	ceremonia	
cerezino	ceresina	TEK
cerio	cerio	KEM
cerumeno	cerilla	ANA
cerumeno	cerumen	ANA
cervedoj	cérvidos	ZOO
cetacoj	cetáceos	ZOO
cetera	demás	
cetere	además	
cetero	resto	
cezio	cesio	KEM
ci	usted	EVI, RAR
cicero	cícero	TIP
cico	pezón	ANA
cidro	sidra	KUI
cifereca	digital	TEK
ciferecigi	digitalizar	TEK
ciferecigilo	digitalizador	TEK
cifero	cifra	EVI, MAT
cigano	gitano	
cigaredo	cigarro	
cigaredo	cigarrillo	
cigno	cisne	FIG, ZOO
cikatriĝi	cicatrizar	MED
cikatro	cicatriz	MED
ciklisto	ciclista	
ciklo	ciclo	MAT
ciklo	ciclo	MAT
ciklono	ciclón	MET
ciklopo	cíclope	MIT
cikorio	endibia belga	BOT
cilindro	cilindro	MAT, TEK
cimbalo	címbalo	MUZ
cimitaro	cimitarra	
cinamo	canela	KUI
cindro	ceniza	
cindrujo	cenicero	
cindrulino	Cenicienta	
cinismo	cinismo	EVI, RAR
ciprino	carpa	ZOO
cirkelo	compás	MAT, TEK
cirklo	círculo	MAT
cirko	circo	ARKI, TEA
cirkonferenco	circunferencia	MAT
cirkonstanco	circunstancia	
cirkulado	circulación	
cirkulero	circular	
cirkuli	circular	EKON, FIZL, TRA
cirkumflekso	circunflejo	EVI, FON, GRA
cirkvito	circuito	ELE, MAT
cirozo	cirrosis	MED
cisterno	cisterna	
citaro	cítara	MUZ
citaĵo	cita	
citi	citar	
citilo	comilla	TIP
citrono	limón	
citronujo	limonero	BOT
civila	civil	
civilizacio	civilización	
civilizi	civilizar	
civilulo	civil	
civitanigi	naturalizar	JUR, POL
civitano	ciudadano	
colo	pulgada	
da	de	
dago	daga	
dajmono	demonio	REL
daktilo	dáctil	POE
dalmatiko	dalmática	KAT, TEKS
daltonismo	daltonismo	MED
damasko	damasco	TEKS
damaĝi	dañar	
damni	condenar	REL
damno	condenación	REL
damo	dama	SPO
damo	reina	SPO
damo	dama	SPO
damo	reina	SPO
damoj	damas	SPO
damludo	damas	SPO
danci	bailar	MUZ
danco	baile	MUZ
dando	dandy	
dando	dandi	
dank'al	gracias a	
danka	agradecido	
danke al	gracias a	
dankema	agradecido	
dankemo	gratitud	
dankemeco	gratitud	
danki	agradecer	ARK, FIG
danko	agradecimiento	
dankado	agradecimiento	
danĝera	peligroso	
danĝero	peligro	
dateno	dato	KOMP
dati	fechar	
dativo	dativo	LIN
dato	fecha	KAL
datreveno	aniversario	KAL
datreveno	efeméride	KAL
datumbanko	banco de datos	KOMP
datumbazo	base de datos	KOMP
datumo	dato	KOMP, SCI
dazipo	armadillo	ZOO
daŭbo	duela	TEK
daŭo	tao	FIL
daŭri	durar	
daŭro	duración	
de	desde	
de	de	
debati	debatir	
debato	debate	
debuti	debutar	
deca	decente	
dece	decentemente	
decembro	diciembre	
deci	ser decente	EVI
deci	tener decencia	EVI
decidi	decidir	
decido	decisión	
decigramo	decigramo	
decilitro	decilitro	
decimala	decimal	MAT
decimalo	decimal	MAT
decimetro	decímetro	
dediĉi	dedicar	
dediĉo	dedicación	
dediĉo	dedicatoria	
dediĉo	dedicación	
dedukti	deducir	
defendi	defender	
defensivo	defensiva	MIL
defetismo	derrotismo	RAR
deficito	déficit	EKON
defili	desfilar	MIL
definitiva	definitivo	
deflacio	deflación	EKON
defraŭdi	defraudar bienes o dinero	
degeneri	degenerar	
degradi	degradar	
dek	diez	
deka	décimo	
dekadencigi	decaer	
dekadenco	decadencia	
dekalogo	decálogo	BIB, KRI
dekano	decano	KRI
dekanti	decantar	KEM
deklami	declamar	POE
deklaracio	declaración	
deklari	declarar	
deklaro	declaración	KOMP
deklinacii	declinar	
deklinacio	declinación	LIN
deklivo	declive	
dekokt(aĵ)o	decocción	KUI, MED
dekonsili	desaconsejar	
malkonsili	desaconsejar	
dekori	decorar	
dekremento	decremento	FIZ
dekreti	decretar	
dekreto	decreto	JUR, POL
deksesuma	hexadecimal	KOMP, MAT
dekstra	derecho	
dekstrino	dextrina	KEM
dekstrulo	diestro	POL
dekstrulo	derechista	POL
dekstruma	dextrógiro	MAT, SCI
dekstruma	horario	MAT, SCI
dekuma	decimal	KOMP, MAT, SCI
delegacio	delegación	
delegi	delegar	
delegito	delegado	
delfeno	delfín	ZOO
delica	delicioso	RAR
delico	delicia	RAR
delikata	delicado	FIG
delikate	delicadamente	
delikto	delito	JUR
deliraĵo	delirio	
deliri	delirar	FIG, MED
delogi	seducir	
forlogi	seducir	
delto	delta	GEOG, LIN
deltoido	deltoides	ANA, MAT
demagogio	demagogia	POL
demagogo	demagogo	POL
demandi	preguntar	
demando	pregunta	
demando	cuestión	
demandosigno	signo de interrogación	TIP
dementi	desmentir	
demokratio	democracia	POL
demokrato	demócrata	POL
demono	demonio	FIG, KRI
demonstracio	demostración	EVI, MAT
demonstrativo	demostrativo	GRA
demonstri	demostrar	EVI, MAT
demonstro	demostración	MAT
denaro	denario	EKON
denominatoro	denominador	MAT
densa	denso	MAT
denseco	densidad	FIZ
denta	dental	
denta	dentado	
dentalo	dental	FON
dentaro	dentadura	ANA
dentkarno	encia	ANA
dentokarno	encia	ANA
dento	diente	ANA
dentopasto	pasta de	
dentopasto	dentrífico	
denunci	denunciar	
departemento	departamento	POL
dependa	dependiente	MAT
dependi	depender	
deploji	desplegar	MIL
deponi	depositar	EKON
deprimi	deprimir	
deprimiĝi	deprimirse	
deprimo	depresión	PSI
deputi	diputar	POL
derivaĵo	derivativo	EKON, GRA, KEM, MAT
derivi	derivar	GRA, MAT
dermatologiisto	dermatólogo	
dermatologio	dermatología	MED
dermatologo	dermatólogo	MED
dermatozo	dermatosis	MED
dermito	dermatitis	MED
dermo	dermis	ANA
derviŝo	derviche	ISL, REL
desegni	calcar	BELA, FIG, TEK
desegni	diseñar (hacer los planos de)	BELA, FIG, TEK
deserto	postre	KUI
desinfektaĵo	desinfectante	
desinfekti	desinfectar	MED
despotismo	despotismo	
despoto	déspota	
detala	detallado	EKON
detale	detalladamente	EKON
detali	detallar	EKON
detalo	detalle	
detekti	detectar	ELE
detektilo	detector	ELE
detektivo	detective	EVI
detektoro	detector	ELE
determini	determinar	GRA
determinismo	determinismo	FIL, SCI
detranĉi	cortar (de)	FIG, MAT
detranĉi	arrancar	FIG, MAT
detranĉi	arrancar	FIG, MAT
fortranĉi	cortar (de)	FIG, MAT
fortranĉi	arrancar	FIG, MAT
fortranĉi	arrancar	FIG, MAT
detrua	destructor	
detrui	destruir	
detruo	destrucción	
detruado	destrucción	
devi	deber	
devii	desviar	FIG, SCI
deviigi	desviar	
devio	desviación	
devizo	divisa	EKON, HER
devizo	lema	EKON, HER
devizo	divisa	EKON, HER
devo	deber	
devo	obligación	
devono	devónico	MIN
dezerta	desértico	
dezerto	desierto	GEOG
deziregi	anhelar	
deziri	desear	
deĉifri	descifrar	KOMP, MIL
deĵori	estar de turno	
deĵori	hacer turno	
deĵoro	turno	
deŝtatigo	privatización	POL
dia	divino	FIG
diabeto	diabetes	MED
diabla	diabólico	
diablaĵo	diablura	
diablo	diablo	FIG, KRI, REL
diabolo	diábolo	SPO
diademo	diadema	HIS
diafana	translúcido	
diafragmo	diafragma	ANA, BOT, ELE, FOT
diagnozi	diagnosticar	
diagnozo	diagnóstico	MED
diagonala	diagonal	MAT
diagonalo	diagonal	MAT
diagramo	diagrama	ELE, SCI
diakono	diácono	KRI
diakrita	diacrítico	LIN
diakritaĵo	letra con un signo diacrítico	LIN, TIP
diakritilo	signo diacrítico	LIN, TIP
dialektiko	dialéctica	FIL, MAH
dialekto	dialecto	LIN
dializi	dializar	KEM, MED
dializo	diálisis	KEM
dialogi	dialogar	
dialogo	diálogo	KOMP
dialogujo	cuadro de diálogo	KOMP
diamanto	diamante	MIN
diametro	diámetro	MAT
diapazono	diapasón	MUZ
diapozitivo	diapositiva	FOT
diapozitivo	transparencia	FOT
diareo	diarrea	MED
diastazo	diastasa	KEM
diastolo	diástole	MED
diatezo	diátesis	MED
diatona	diatónico	MUZ
didaktika	didáctico	
didaktiko	didáctica	PED
dielektrika	dieléctrico	
dielektriko	dieléctrico	ELE
dierezo	diéresis	EVI, FON
dieso	sostenido	KOMP, MUZ
dieso	almohadilla	KOMP, MUZ
dieto	dieta	MED
difekto	defecto	
diferenca	diferente	
diferenco	diferencia	MAT
difina artikolo	artículo determinado	GRA
difina artikolo	artículo definido	GRA
difini	definir	ARK, GRA
difino	definición	
difrakto	difracción	FIZ
diftongo	diptongo	FON
difuzi	difundir	FIZ, KEM
difuzilo	difusor	
difuzo	difusión	
digesti	digerir	FIG
digitalino	digitalina	KEM
digo	dique	MAR
dikfingro	pulgar	ANA
diklina	diclino	BOT
diktatora	dictatorial	
diktatoreco	dictadura	POL
diktatorema	dictatorial	
diktatoro	dictador	POL
diktaĵo	dictado	POL
dikti	dictar	FIG
dilati	dilatar	FIZ, MED
dilato	dilatación	FIZ
dilemo	dilema	
diligenta	diligente	
dilui	diluir	FIZ, KEM
diluvo	diluvio	
dimanĉo	domingo	KAL
dimensio	dimensión	FIZ, KOMP, MAT, SCI, TEK
diminutivo	diminutivo	GRA
dinamiko	dinámica	FIZ, MAT
dinamismo	dinamismo	FIL
dinamito	dinamita	KEM, TEK
dinamo	dínamo	ELE, TEK
dinamometro	dinamómetro	MED, TEK
dinaro	dinar	EKON
dinastio	dinastía	POL
dinoterio	dinoterio	PAL, ZOO
dio	dios	FIL, MIT, REL
diocezo	diócesis	HIS, KRI
diodo	diodo	ELE
dioptrio	dioptría	FIZ, FOT
dipatrino	Madre de Dios	KRI
diplomata	diplomático	
diplomatiisto	diplomático	
diplomatio	diplomacia	POL
diplomato	diplomático	FIG, POL
diplomo	diploma	PED
diptiko	díptico	BELA
diraka kombilo	peine de Dirac	MAT
direkcio	dirección	
direkti	dirigir	
direkto	dirección	MAT
direktoro	director	
diri	decir	
diro	dicho	
disciplini	disciplinar	
disciplino	disciplina	
disdegni	desdeñar	RAR
disdegni	desestimar	RAR
disdegno	desdén	RAR
disdegno	desestimo	RAR
disdoni	repartir	
disenterio	disentería	
disfaldi	desdoblar	
malfaldi	desdoblar	
disgrajnigi	desgranar	
disjunkcio	disyunción	MAT
disjunkcio	disjunción	MAT
diskaparato	disco duro	KOMP
disketo	disco flexible	KOMP
disko	disco	KOMP, MAT, MUZ, SPO
diskreta	discreto	FIG, MAT
diskriminacio	discriminación	POL
diskriminanto	discriminante	MAT
diskturnilo	unidad de disco	KOMP
diskurso	discurso	BELE
diskuti	discutir	
dispecigi	despedazar	
dispepsio	dispepsia	MED
dispneo	disnea	MED
dispozicio	disposición	JUR, MED
dispozicio	predisposición	JUR, MED
disprozio	disprosio	KEM
disputi	disputar	
dissemi	diseminar	FIG
distanco	distancia	MAT
distiko	dístico	POE
distilado	destilación	
distili	destilar	KEM
distingi	distinguir	
distingo	distinciónr	
distribui	distribuir	
distrikto	distrito	POL
disurio	disuria	MED
disĉiplo	discípulo	FIL, PED, REL
ditirambo	ditirambo	BELE, FIG, POE
divano	diván	HIS
diveni	adivinar	
divenisto	adivino	
diversa	diverso	
diverseco	diversidad	
diversigi	diversificar	
diverĝenco	divergencia	MAT
dividanto	divisor	MAT
dividato	dividendo	MAT
dividaĵo	divisiónr	
dividebla	divisible	MAT
dividendo	dividendo	EKON
dividi	dividir	MAT
divido	división	MAT
divizio	división	BOT, MIL
divizori	ser divisor de	MAT
divizoro	divisor	MAT
dizajni	Diseñar	
dizajnisto	Diseñador	
dizajno	diseño	
dizelo	motor disel	AUT, TEK
dizerti	desertar	MIL
diĥotomio	dicotomía	SCI
docento	docente	PED
dogano	arancel	EKON
dogmo	dogma	FIG, REL
doktoro	doctor	MED, SCI
doktrino	doctrina	FIL, REL, SCI
dokumenti	documentar	
dokumento	documento	
dolaro	dólar	EKON
doloro	dolor	
dolĉa	dulce	
domeno	dominó	RAR, SPO, TEKS
domicilo	domicilio	JUR
domini	dominar	
dominikano	dominico	KAT
dominikano	dominicano	KAT
domo	casa	ARK, ARKI, GEN
donaci	donar	
donaco	donación	
doni	dar	FIG
dormi	dormir	FIG
dormosako	saco de dormir	
dorna	espinoso	FIG
dornfiŝeto	espina	
dorno	espina	FIG
dorso	espalda	ANA, FIG, ZOO
dorso	dorso	ANA, FIG, ZOO
dorsosako	mochila	
dosiero	archivo	KOMP
dosiero	expediente	KOMP
dosiero	archivo	KOMP
dosierujo	directorio	KOMP
doto	dote	
dozi	dosificar	
dozo	dosis	FIG, MED
doĝo	dux	
dragi	dragar	TEK
dragmaŝino	draga	TEK
drako	dragón	MIT, SPO
drakona	draconiano	
drama	dramático	FIG, TEA
dramaturgio	dramaturgia	TEA
dramo	drama	FIG, TEA
drato	alambre	TEK
draŝi	trillar	AGR, FIG
dreliko	tela vaquera	TEKS
dreni	drenar	AGR
drenilo	drenaje	
dresi	entrenador	
dresi	entrenar	
driado	dríade	MIT
driado	dríada	MIT
drivi	ir a la deriva	AVI, MAR
drogo	droga	KEM, MED
drogo	medicamento	KEM, MED
drogo	medicina	KEM, MED
dromedaro	dromedario	ZOO
druido	druida	REL
du	dos	
dualo	dual	GRA, MAT
duba	dudoso	
(pri)dubebla	dudoso	
dubi	dudar	
dubinda	dudoso	
dublono	doblón	EKON
dudieso	doble sostenido	MUZ
duelo	duelo	
dueto	dueto	MUZ
duflanka oligopolo	oligopolio bilateral	EKON
duhufa	bisulco	
duhufa	de pezuña hendida	
dukato	ducado	EKON, HIS
duko	duque	
dulorneto	gemelos	FOT
dulorneto	prismáticos	FOT
dulorneto	binoculares	FOT
dum	mientras	
dume	mientras	
dungi	contratar	EKON, JUR
duno	duna	GEOG
dunombro	dual	GRA
duobla	doble	
duodeno	duodeno	ANA
duonfilino	hijastra	GEN
duonfilo	hijastro	GEN
duonfrato	medio hermano	GEN
duonglobo	hemisferio	
duoninsulo	península	GEOG
duonjaro	semestre	AST, KAL
duono	mitad	
duonpalto	chaquetón	TEKS
duonpalto	pelliza	TEKS
duonsfero	semiesfera	AST, GEOG, MAT
duopolo	duopolio	EKON
dupleksa	dúplex	TEL
duplikati	duplicar	
duplikato	duplicado	
duro	duro	EKON, HIS
duuma	binario	KOMP, MAT
duvalvuloj	bivalvos	ZOO
duŝi	duchar	
duŝo	ducha	
e-vorto	adverbio	GRA
ebeno	plano	MAT
ebla	posible	
eble	posiblemente	
ebligi	hacer posible	
eblo	posibilidad	
ebonisto	ebanista	
ebonito	ebonita	ELE, KEM
ebono	ébano	
ebria	ebrio	FIG
ebria	borracho	FIG
eburo	marfil	
eco	cualidad	
edemo	edema	MED
edeno	edeén	FIG
eduki	educar	PED
edukisto	educador	PED
efemeridoj	efémerides	AST
eferveska	efervescente	
efesano	efesio	BIB, HIS
efika	eficaz	
efikeco	eficacia	
efiki	producir efecto	
efiki	actuar	
efiki	ser	
efiki	ser	
efiki	hacer efecto	
efiko	efecto	
egala	igual	EVI, MAT
egalanimeco	ecuanimidad	
egalaĵo	igualdad	MAT
egali	es igual a	
egaligi	igualar	
egalpezo	equilibrio	
egido	égida	MIT, POL
egido	egida	MIT, POL
egipta	egipcio	
egipto	egipcio	EVI, HIS, POL
egipto	egipcio	EVI, HIS, POL
egipto	Egipto	EVI, HIS, POL
egiptujano	egipcio	
eglefino	eglefino	ZOO
egoismo	egoísmo	
egoismulo	egoísta	
egoista	egoísta	
egoisto	egoísta	
ejnstejnio	einstenio	KEM
ejnŝtejnio	einstenio	KEM
ekaboni	inscribirse en	
ekflami	prender fuego	
ekimozo	equimosis	MED
ekino	erizo de mar	ZOO
ekipaĵo	equipo	
ekipi	equipar	
ekkompreni	empezar a entender	
ekkompreni	entrever	
ekkompreni	darse cuenta	
eklampsio	eclampsia	MED
eklipsi	eclipsar	AST, FIG
eklipso	eclipse	AST
ekliptiko	eclíptica	AST
eklogo	égloga	BELE, POE
eklumigi	encender	
ekonomia	económico	
ekonomiko	economía	EKON
ekonomio	economía	EKON
ekrano	pantalla	FOT, KOMP, TEK
eks-	ex-	
ekscelenco	excelencia	
ekscentra	excéntrico	RAR
ekscesa	excesivo	
eksceso	exceso	
eksciteco	excitación	
eksciti	excitar	FIG
ekscitiĝi	excitarse	
ekskludi	excluir	
ekskrecii	excretar	
ekskrecio	excreción	ANA
ekskremento	excremento	ANA
ekskurso	excursión	
ekskuzi	excusar	
ekslibriso	ex libris	
ekspansio	expansión	EKON, JUR, TEK
ekspedicio	expedición	MIL, SCI
ekspekto	esperanza matemática	MAT
eksperimenta	experimental	
eksperimenti	experimentar	
eksperimento	experimento	SCI
ekspertizisto	experto	
ekspertizo	esperticia	
eksperto	experto	
ekspliki	explicar	
eksplodaĵo	explosivo	KEM, MIL, TEK
eksplodi	explotar	FIG
ekspluati	explotar	EKON, POL
eksponencialo	exponencial	MAT
eksponi	exponer	FOT
eksportado	exportación	EKON
eksporti	exportar	EKON, KOMP
eksportisto	exportador	EKON
ekspozi	exponer	
ekspozicii	exponer	
ekspozicio	exposición	
ekstazo	étasis	
ekstemporalo	extemporaneo	
ekster	afuera de	ARK
ekstera	externo	
ekstere	externamente	
ekstermi	exterminar	
eksterordinara	extraordinario	
eksterpoli	extrapolar	MAT
ekstra	extra	EVI
ekstradicii	extraditar	JUR
ekstradicio	extradición	
ekstrakti	extraer	FIG, KEM
ekstrakto	extracto	KEM, KUI
ekstrapoli	extrapolar	MAT
ekstravaganco	extravagancia	
ekstrema	extremo	
ekstremaĵo	extremo	
ektopio	ectopía	ANA
ektropio	ectropión	MED
ekumena	ecuménico	KRI, REL
ekumena koncilio	concilio ecuménico	KAT, KRI
ekumena koncilio	concilio general	KAT, KRI
ekumenismo	ecumenismo	KRI, REL
ekumeno	ecúmene	
ekvaciaro	sistema de ecuaciones	MAT
ekvacio	ecuación	MAT
ekvatorialo	ecuatorial	AST
ekvatoro	ecuador	GEOG
ekvilibri	estar en equilibrio	
ekvilibrigi	equilibrar	
ekvilibristo	equilibrista	
ekvilibro	equilibrio	FIG
ekvinoksa punkto	punto equinoccial	AST
ekvinokso	equinoccio	AST, KAL
ekzakta	exacto	
ekzalti	exaltar	
ekzameni	examinar	PED
ekzameno	exámen	PED
ekzantemo	exantema	MED
ekzekuti	ejecutar	JUR
ekzemo	eccema	MED
ekzemple	por ejemplo	
ekzemplero	ejemplar	
ekzemplo	ejemplo	LIN
ekzili	exiliar	
ekzistado	existencia	
ekzisti	existir	
ekzistismo	existencialismo	FIL
ekzistadismo	existencialismo	FIL
ekzorcaĵo	exorcismo	
ekzorci	exorcizar	REL
ekzorcizi	exorcizar	
ekzota	exótico	
ekzotika	exótico	
elasta	elástico	FIG
elaĉeti	redimir	
elaĉeti	rescatar	
elaĉeti	recuperar	
elcento	porcentaje	
elcento	tanto por ciento	
elefanto	elefante	ZOO
eleganta	elegante	
elegantulo	catrín	
elegio	elegía	BELE, POE
elekti	elegir	POL, REL
elektra	eléctrico	
elektra fajrero	chispa eléctrica	ELE
elektra fluo	corriente eléctrica	ARK, ELE
elektra kampintenso	intensidad del campo eléctrico	ELE
elektra kampo	campo eléctrico	ELE
elektra streĉo	voltaje	ARK, ELE
elektrejo	central electrica	TEK
elektrigi	electrificar	
elektrismo	electricidad	FIZ
elektristo	electricista	
elektrizi	electrizar	ELE
elektro	electricidad	ELE, FIZ
elektrodo	electrodo	ELE, TEK
elektrolito	electrolito	ELE, KEM
elektrolizi	electrolizar	ELE, KEM
elektrolizo	electrolisis	ELE, KEM
elektrolizo	electrólisis	ELE, KEM
elektromagneta	electromagnético	FIZ
elektromagneta kampo	campo electromagnético	FIZ
elektromagnetismo	electromagnetismo	FIZ
elektromagneto	electroimán	FIZ, TEK
elektrometro	electrómetro	ELE
elektrono	electrón	ELE, FIZ
elektroskopo	electroscopio	ELE
elektrostatiko	electroestática	ELE, FIZ
elektroterapio	electroterapia	MED
elektroĥemio	electroquímica	KEM, SCI
elementa	elemental	
elemento	elemento	FIL, KEM, MAT, PED
elevatoro	elevador	TEK
elfo	elfo	MIT
eliksiro	elíxir	FIG, MED
elimini	eliminar	MED
elimino	electrodo	MAT
elipso	elipse	GRA, MAT
elipsoido	elipsoide	MAT
eliri	Éxodo	BIB, FIG
elito	élite	
elitro	élitro	ZOO
elizeo	paraíso	FIG
elizii	elidir	FON, GRA
elmodiĝi	pasar de moda	
elokventa	elocuente	
elspezi	gastar	EKON
elspiri	expirar	FIG
elsuĉa	&leftquot;tal que lo deja a uno acabado&rightquot;	
elsuĉi	succionar	FIG
elsuĉi	chupar	FIG
elsuĉi	acabar	FIG
elsuĉi	acabar	FIG
elterigi	desenterrar	
eltrovi	encontrar	
eltrovi	descubir	
elvaporiĝi	evaporarse	
elŝeligi	pelar	FIG
elŝuti	descargar	KOMP
elŝuti	bajar	KOMP
elŝuti	descargar	KOMP
emancipi	emancipar	JUR, KOMUNE
embargi	embargar	EKON, JUR, MAR, POL
emblemo	emblema	SPO
emblemo	palo	SPO
embolio	embolia	MED
embrio	embrión	BIO, FIG
embriologiisto	embriólogo	
embriologio	embriología	SCI
embriologo	embriólogo	SCI
emerituro	pensión de jubilación	EKON
emerituro	jubilación	EKON
emerĝi	emerger	FIZ, FOT
emetiko	emético	MED
emfazi	enfatizar	
emfazo	énfasis	
emfizemo	enfisema	MED
eminenco	eminencia	KAT
eminenta	eminente	
eminentulo	eminencia	
emiro	emir	POL
emirujo	emirato	POL
emisii	emitir	EKON, FIZ
emocii	emocionar	
emociiĝi	emocionarse	
emocio	emoción	FIL
emulsio	emulsión	FIZ, KEM, KUI
en	en	
enamiĝi	enamorarse	
enbalzamigi	embalsamar	
encefalito	encefalitis	MED
encefalo	encéfalo	ANA
encefalopatio	encefalopatía	MED
encikliko	encíclica	KAT
endemia	endémico	
endivio	endibia	BOT
endokarpo	endocarpio	BOT
endoskopio	endoscopia	MED
endoskopo	endoscopio	MED
energio	energía	FIZ
enfermi	encerrar	
enfili	enfilar	MIL
enhaveco	capacidad	
enhavi	contener	MAT
enhavo	contenido	TIP
enigma	enigmático	
enigmo	enigma	FIG, SPO
enkadrigi	encuadrar	
enkanonigi	canonizar	KRI
enkapti	atrapar	
enketi	encuestar	
enketisto	encuestador	
enketo	Encuesta	
enkursigi	encaminar	POSX
enkursigilo	encaminador	KOMP
kursilo	encaminador	KOMP
enmerkatigi	comercializar	EKON
enmigri	migrar	
ensemblo	ensamble	ARKI, BELA, MUZ, TEA, TEKS
ensiligi	ensilar	
enspezimposto	impuesto sobre la renta	EKON
enspiri	inspirar	
entablemento	entablamento	ARKI
enterigi	enterrar	FIG
enterito	enteritis	MED
entjero	entero	MAT
entomologio	entomología	SCI
entrepreni	emprender	
entreprenisto	empresario	EKON
entrepreno	empresa	EKON
entrepreno	empresa	EKON
entropio	entropía	FIZ, MAT, MED
entrudiĝi	entrometerse	
entrudulo	entrometido	
entrudulo	metido	
entuziasmo	entusiasmo	
enua	aburrido	
enui	aburrirse	
enuiga	aburrido	
enuigi	aburrir	
enuo	aburrimiento	
enverguro	envergadura	AVI, MAR, ZOO
envido	introspección	PSI
enviema	envidioso	
envii	envidiar	
enviinda	envidiable	
envio	envidia	
eoceno	eoceno	GEOL
eozino	eosina	FOT, KEM, MED
epakto	epacta	AST
ependimo	epéndimo	ANA
epidemia	epidémico	
epidemio	epidemia	MED
epigastro	epigastrio	ANA
epigloto	epiglotis	ANA
epigono	epígono	BOT
epigono	epígono	BOT
epigrafo	epígrafe	ARKE, ARKI
epigramo	epigrama	BELE, POE
epilepsio	epilepsia	MED
epilogo	epílogo	TEA
epistolo	epístola	BELE, KAT
epitafo	epitafio	
epitelio	epitelio	ANA
epiteto	epíteto	BELE, GRA
epoko	época	HIS
epopeo	epopeya	BELE, FIG, POE
erao	era	EVI, FIG, GEOL, KAL
erbio	erbio	KEM
ergo	ergio	TEK
ergonomia	ergonómico	
ergonomio	ergonomía	TEK
ergotino	ergotina	KEM, MED
erizipelo	erisipela	MED
ermito	ermitaño	FIG, REL
ermito	anacoreta	FIG, REL
ero	era	
erodi	erosionar	
erodo	eroción	
erotika	erótico	BELE
erotomanio	erotomanía	MED
erozii	erosionar	
erozio	eroción	MIN
erudiciulo	erudito	
erudito	erudito	
erupcii	erupcionar	
erupcii	hacer erupción	
erupcio	erupción	GEOL, MED
escepti	exceptuar	
escepto	excepción	
esenca	esencial	
esenco	esencia	FIL, KOMUNE, KRI
eskadrono	escuadrón	MIL
eskalo	escalerilla	RAR
eskapi	escapar	
eskludi	excluir	
eskorti	escoltar	
eskorto	escolta	
eskudo	escudo	
esperantisto	esperantista	ESP
esprimi	expresar	
esprimo	expresión	KOMP, MAT
establaĵo	establecimiento	EKON, POL
establejo	establecimiento	EKON, POL
establi	establecer	
establo	establecimiento	
estanteco	presente	GRA
estaĵo	ser	
estaĵo	ente	
estetika	estético	
estetiko	estética	FIL
esti	ser	
esti	estar	
estimi	estimar	
estiminda	estimable	
estimo	estima	
estingi	extinguir	FIG
estingiĝi	extinguirse	
estinteco	past	GRA
estinteco	pasado	GRA
estonteco	futuro	GRA
estrado	estrado	
estro	jefe	
estro	dirigente	
estro	superior	
estuaro	estuario	GEOG
estulo	ser	
estulo	ente	
etendaĵo	extensión	
etendebla	extensible	
etendi	extender	FIG, TEK
etendiĝi	extenderse	FIG
etendiĝi	propagarse	FIG
eterna	eterno	
etika	ético	
etikedo	etiqueta	
etiketo	etiqueta	
etiko	ética	FIL
etileno	etileno	KEM
etilo	etilo	KEM
etimologio	etimología	LIN, SCI
etmoido	etmoides	ANA
etnografio	ethnographía	SCI
etnografo	etnógrafo	SCI
etnologiisto	etnólogo	
etnologio	etnología	SCI
etnologo	etnólogo	SCI
etologio	etología	SCI
etoso	ambiente	
evakui	evacuar	
evakuo	avacuación	
evangelia	evangélico	
evangelio	evangelio	BIB, EVI, FIG, KRI
evento	evento	
eventual(aĵ)o	eventualidad	
eventuala	eventual	
eventuale	eventualmente	
evidenta	evidente	
evidente	evidentemente	
evitebla	evitable	
eviti	evitar	
evitvorto	eufemismo	
evolucii	evolucionar	
evolucio	evolución	
evolui	evolucionar	
evoluo	evolución	
ezofago	esófago	ANA, ZOO
eĉ	incluso	
eĉ	aun	
eĥino	erizo de mar	ZOO
eĥo	eco	FIG, KOMP
eŭdiometrio	eudiometría	FIZ
eŭfemismo	eufemismo	
eŭgeniko	eugenesia	SCI
eŭkalipto	eucalipto	BOT
eŭnuko	eunuco	
eŭro	euro	EKON
eŭropa	europeo	
eŭropio	europio	KEM
fabela	fabuloso	
fabelo	fábula	BELE, FIG
fablo	fábula	BELE
fabrikado	fabricación	
fabrikanto	fabricante	EKON
fabriki	fabricar	EKON
fabriko	fábrica	EKON
facila	fácil	
facile	fácilmente	
faciligi	facilitar	
fagocito	fagocito	MED
fajenco	loza	TEK
fajrestingilo	extintor	
fajrobrigadisto	bombero	
fajrobrigado	cuerpo de bomberos	
fakiro	faquir	REL
fakte	de hecho	
fakto	hecho	
faktorialo	factorial	MAT
faktoro	factor	EKON, MAT
faktoro	factor	EKON, MAT
fakturi	facturar	EKON
fakturo	factura	EKON
fakultato	facultad	PED
falakvo	cascada	GEOG
falango	falange	ANA, HIS, MIL
faldi	doblar	
faldo	doblez	
faldaĵo	doblez	
fali	caer	FIG
falko	halcoón	ZOO
falo	caída	
falsa	falso	MUZ
falsa amiko	falso amigo	LIN
falsi	falsear	
falsi	falsificar	
falstelo	estrella fugaz	AST
falto	arruga	ANA
falĉi	segar	AGR, FIG
falĉilo	guadaña	AGR
falĉilo	hoz	AGR
falĉmaŝino	segadora	AGR
fama	famoso	
fameco	fama	
familia	familiar	
familiara	familiar	
familio	familia	BOT, GEN, GRA, MAT, ZOO
famo	rumor	
famo	fama	
famulo	famoso	
fanatika	fanático	
fanatikulo	fanático	
fandango	fandango	MUZ
fandi	fundir	TEK
fanerogamoj	fanerógamas	BOT
fanfaro	fanfarria	MUZ
fanfaroni	fanfarronear	
fanfaronulo	fanfarrón	
fantazia	fantástico	
fantazio	fantasía	
fanto	sota	SPO
fanto	joto	SPO
fanto	jack	SPO
fantomo	fantasma	FIG
farandolo	farándula	MUZ
faraono	faraón	HIS, POL
farbi	pintar	
farbisto	pintor	
farbo	maquillaje	ARK
farbo	pintura	ARK
farboplato	paleta	BELA
fari	hacer	BIB
faringo	faringe	ANA
fariseo	fariseo	EVI, FIG, HIS, REL
farmaciaĵo	fármaco	MED
farmaciisto	farmacéutico	MED
farmacio	farmacia	MED
farmakologio	farmacología	MED
farmakopeo	farmacopea	MED
farso	farsa	TEA
farti	estar de salud	
faruno	harina	KUI
fasado	fachada	ARKI, KOMP
fasado	Interfaz de Usuario	ARKI, KOMP
fascina	fascinante	FIG
fascini	fascinar	
fascino	fascinación	
fasti	ayunar	FIG, REL
fasto	ayuno	
fatala	fatal	
fatalaĵo	fatalidad	
fatalismo	fatalismo	FIL
fato	destino	
favora	favorable	
favora	propicio, -a	
favorato	favorecido	
favorato	favorito	
favoraĵo	favor	
favori	preferir	
favori	ser favorable a	
favori	favorecer	
favorigi	favorecer	
favoro	favor	
fazeolo	frijol	BOT
fazo	fase	AST, FIZ, MAT
faŝisto	fascista	
faŭno	fauno	MIT, ZOO
faŭno	fauna	MIT, ZOO
fea	mágico, -a	FIG
febla	débil	RAR
febra	febril	FIG, MED
febri	tener fiebre	FIG, MED
febro	fiebre	FIG, MED
februaro	febrero	
federacio	federación	JUR
federo	federación	POL
feino	hada	
feki	defecar	FIZL
fekulo	fécula	KUI
fekunda	fértil	FIG
feldspato	feldespato	MIN
felisedoj	félidos	ZOO
feliso	felino	ZOO
feliĉa	feliz	
feliĉe	felizmente	
feliĉo	felicidad	
felpo	felpa	TEKS
felpo	peluche	TEKS
feminismo	feminismo	
feministo	feminista	
femuro	fémur	ANA
fendi	hendir	FIG
fendi	cortar	FIG
fendi	rajar	FIG
fendo	hendidura	FIG
fendo	cortadura	FIG
fendo	rajadura	FIG
fenestro	ventana	KOMP
fenikso	fénix	FIG, MIT, RAR
fenolo	fenol	KEM
fenomena	fenomenal	
fenomeno	fenómeno	FIG, FIL
feo	genio	MIT
fera	de hierro	FIG
ferbetono	hormigón armado	KON
subferigita betono	hormigón armado	KON
armita betono	hormigón armado	KON
ferdeko	cubierta	MAR
ferio	vacaciones	
fermentado	fermentación	
fermenti	fermentar	
fermento	fermento	KEM
fermi	cerrar	FIG
fermio	fermio	KEM
fermita	(sílaba) trabada	FON, MAT
fero	hierro	KEM
fervoro	fervor	
festeno	banquete	KUI
festi	festejar	
festivalo	festival	
festlibro	homenaje	TIP
festo	fiesta	KAL
fetiĉismo	fetichismo	FIG
fetiĉo	fetiche	FIG
feto	feto	ANA
feŭdismo	feudalismo	POL
feŭdo	feudo	EKON
feŭdoĉefo	señor feudal	
feŭdestro	señor feudal	
fianĉo	prometido	
fianĉo	novio	
fiasko	fiasco	
fibro	fibra	FIG, TEK, TEKS
fibromo	fibroma	MED
fidela	fiel	
fidi	confiar	
fidi	tener fe	
fidinda	confiable	
fido	confianza	
fido	fe	
fier(ec)o	orgullo	
fiera	orgulloso, -a	
fieri	estar orgulloso, -a	
fieri	enorgullecerse	
fierinda	digno,-a de orgullo	
fierulo	orgulloso	
figuro	figura	BELE, FIG, LIN, SPO
fikcia	ficticio	
fikcio	ficción	
fiki	follar	VULG
fiksa	fijo	
fiksi	fijar	FIG, FOT
fiksilo	fijador	FOT, TEK
fiksita disko	disco duro	KOMP
fiktiva	ficticio	
filamento	filamento	ANA, BOT, ELE, TEK
filantropio	filantropía	
filantropo	filántropo	
filatelio	filatelia	POSX
filatelo	filatelia	POSX, SPO
filharmonio	filarmónica	MUZ
filigi	adoptar un hijo	GEN
filino	hija	GEN
filio	filial	EKON
filmi	filmar	KIN
filmo	película	FIZ, FOT, KIN, TEK
filo	hijo	GEN
filologiisto	filólogo	
filologio	filología	LIN, SCI
filozofi	filosofar	
filozofii	filosofar	
filozofio	filosofía	ARK, FIL, SCI
filozofo	folósofo	FIL
filtri	filtrar	FOT
filtrilo	filtro	MAT
fingringo	dedal	
fingro	dedo	ANA
fingrospuro	huella digital	
finpretigi	acabar	
firmo	firma comercial	EKON
firmo	Empresa	EKON
firmo	Firma	EKON
fiska	fiscal	EKON
fisko	fisco	EKON
fistulo	fístula	MED
fitoterapio	fitoterapia	MED
fizika	físico	
fiziko	física	FIZ, SCI
fiziologiisto	fisiólogo	FIZL
fiziologio	fisiología	FIZL, SCI
fiziologo	fisiólogo	
fiŝ(kapt)i	pescar	
fiŝĉasi	pescar	
fiŝhoko	anzuelo	
fiŝisto	pescador	
fiŝisto	piscicultor	
fiŝo	pez	ZOO
flago	bandera	
flako	charco	
flama	ardiente	FIG
flami	arder	
flamigi	quemar	
flamiĝema	inflamable	
flamiĝi	arder	
flamiĝi	quemarse	
flamo	flama	FIG, FIZ
flanelo	franela	TEKS
flanka	lateral	FIG
flanko	lado	ARK, FIG, MAT
flano	flan	KUI
flanĝo	brida	TEK
flari	oler	
flarpovo	olor	
flarkapablo	olor	
flava	amarillo	
flavo	amarillo	
flegi	cuidar	FIG
flegisto	enfermero	MED
flegisto	enfermera	MED
flegmono	flemón	MED
fleksia	flexivo	LIN
fleksio	inflexión	GRA
flikaĵo	parche	
fliki	parchar	FIG
flikteno	flictena	MED
flirti	revolotear	
flirti	ondear	
flirti	aletear	
flirti	coquetear	
flirti	flirtear	
flirti	ligar	
floreno	florín	EKON
florfolio	pétalo	BOT
flori	florear	FIG
floro	flor	BOT, FIG
flosi	flotar	
floso	balsa	
floso	armadía	
floto	flota	MAR, MIL
fluaĵo	fluido	FIZ
flugi	volar	AVI, FIG
flugila	alado	
flugilo	ala	AVI, FIG, POE, ZOO
flugo	vuelo	
flugado	vuelo	
flui	fluir	FIG
fluktui	fluctuar	FIG, SCI
fluo	flujo	
fluoreska	fluorescente	
fluoresko	fluorescencia	
fluoro	flúor	KEM
flustri	cuchichear	FIG, FON
flustri	murmurar	FIG, FON
flustri	murmurar	FIG, FON
fluto	flauta	MUZ
fobio	fobia	MED
foiro	feria	EKON
foko	foca	ZOO
fokstroto	fox-trot	MUZ
fokuso	foco	FIG, FOT, MAT
foliaro	follaje	
folii	hojear	KOMP
foliumi	hojear	KOMP
folio	hoja	BOT
foliumilo	explorador	KOMP
foliumilo	navegador	KOMP
folkloro	folclore	BELA
fondaĵo	fundación	EKON
fondi	fundar	FIG
fondi	fundamentar	FIG
fonduso	fondo	EKON
fonemo	fonema	FON
fonetika	fonético	
fonetiko	fonética	FON, LIN
fonetismo	fonetismo	LIN
fono	fondo	
fonografo	fonógrafo	TEK
fonologio	fonología	FON, LIN, SCI
fontanelo	fontanela	ANA
fontano	fuente	
fonto	manantial	FIG
fonto	fuente	FIG
for	lejos	
fora	lejano	KOMP, TEK
foraĵo	lejanía	
forceja efiko	efecto invernadero	EKOL, FIZ
forcejo	invernadero	HOR
forcepso	fórceps	MED
foresti	estar ausente	
forgesi	olvidar	
forigi	alejar	
foriĝi	alejarse	
forkego	trinche	AGR
forkiĝi	bifurcarse	
forko	bifurcación	FIG, KUI
forko	tenedor	FIG, KUI
forkomerci	agotar	EKON
forkomuniigi	excomulgar	
formacio	formación	GEOL, MIL
formado	formación	
formala	formal	
formala polinomo	polinomio formal	MAT
formalaĵo	formalidad	
formaldehido	formaldehído	KEM
formalismo	formalismo	
formato	formato	KOMP, TIP
formi	formar	MIL
formikejo	hormiguero	
formiko	hormiga	KOMUNE, ZOO
formilo	molde	
formujo	molde	
formiĝi	formarse	
formo	forma	MAT
formolo	formol	KEM
formularo	formulario	
formulo	fórmula	KEM, MAT
forno	horno	KUI, TEK
forsitio	campanita china	BOT
forta	fuerte	ARK, FON, POE
forto	fuerza	FIZ, TEK
fortreso	fortaleza	ARKI, MIL
fortuno	fortuna	
forumo	foro	FIG, KOMP
forvaporiĝi	evaporarse	
forĝi	forjar	FIG, TEK
fosfato	fosfato	KEM
fosfaturio	fosfaturia	MED
fosforeska	fosforescente	
fosforesko	fosforescencia	
fosforo	fósforo	KEM
fosiliiĝi	fosilizarse	
fosilio	fósil	MIN
fotaparato	cámara fotográfica	FOT
fotoaparato	cámara fotográfica	FOT
fotelo	sillón	
foti	fotografiar	FOT
fotilo	cámara fotográfica	FOT
fotisto	fotógrafo	
foto	fotografía	FOT
fotografaĵo	fotografía	FOT
fotografilo	cámara fotográfica	FOT
fotografio	fotografía	BELA, FOT
fotografisto	fotógrafo	
fotometro	fotómetro	FIZ
fotono	fotón	FIZ
fotosfero	fotosfera	AST
fototipio	fototipia	TIP
fragment(ig)i	fragmentar	
fragmento	fragmento	
frago	fresa	
fragujo	fresero	BOT
frajto	flete	
frakasi	hacer fracasar	FIG
frakasi	hacer fracasar	FIG
frakciigi	fraccionar	
frakcio	fracción	MAT, POL
frambo	frambuesa	BOT
franca	francés	
francio	francio	KEM
franciskano	franciscano	KAT
franciumo	francio	KEM
franclingvano	francohablante	
franclingvano	frencoparlante	
franco	francés	
frandi	degustar	
frandi	saborear	
franko	franco	EKON
frankolino	francolín	ZOO
frapinstrumento	instrumento de percusión	MUZ
frata	fraterno	
frateco	fraternidad	
fratino	hermana	GEN
frato	hermano	FIG, GEN
fratrio	fratria	
fraŭdi	estafar	JUR
fraŭdo	estafa	
fraŭlino	soltera	GEN
fraŭlo	soltero	GEN
fregato	fragata	HIS, MAR, MIL, ZOO
frekvenco	frecuencia	ELE, EVI, FIZ, TEK
frekvencometro	frecuenciómetro	ELE, FIZ
frekventi	frecuentar	
fremda	extranjero	
frenologio	frenología	SCI
fresko	pintura al fresco	BELA
frezi	fresar	TEK
frezilo	fresa	TEK
frezmaŝino	fresadora	TEK
freŝa	fresco	
freŝeco	frescura	
frida	frío	NEO
fridujo	refrigerador	
frikativo	fricativa	FON
friponaĵo	timo	
friponeto	pícaro	
friponi	timar	
fripono	Timador	
fripono	Granuja	
fritaĵo	fritura	KUI
friti	freír	KUI
fritilo	freidora	
frito	papas a la francesa	
frivola	frívolo	
fromaĝo	queso	KUI
fronto	frente	
frosto	helada	MET
froti	frotar	
froto	frotación	
froto	fricción	
frukti	dar fruto	FIG
frukto	fruto	BOT, FIG, KOMUNE, KUI
fruntaĵo	frente	ARK, ARKI
frunto	frente	ANA, ZOO
fruntosto	frontal	ANA
fulmo	rayo	FIG, MET
fulmofermilo	cierre	TEKS
fulmofermilo	zipper	TEKS
fulmofermilo	cremallera	TEKS
fulmoforigilo	pararrayos	ELE, TEK
fulmoŝirmilo	pararrayos	ELE, TEK
fumaĵi	ahumar	KUI, TEK
fumi	fumar	
fumo	humo	FIG
fundamenta	fundamental	ESP, FIG, GRA, KON
fundamentismo	fundamentalismo	ESP, REL
fundamento	cimiento	FIG, KON
fundamento	fundamento	FIG, KON
fundo	fondo	ARK, FIG
funelo	embudo	
fungo	hongo	BIO, KOMUNE
funto	libra	
furaĝo	forraje	AGR
furio	furia	FIG, MIT
furioza	furioso	
furiozi	estar furioso	
furorkanto	éxito	MUZ
furorkanto	hit	MUZ
furzi	pedo	
futbalisto	futbolista	
futbalo	balonpié	SPO
futbalo	futbol	SPO
futbalo	fútbol	SPO
futo	pie	
futuro	futuro	GRA, RAR
fuzelaĝo	fuselaje	AVI
fuĝi	fugar	
gadolinio	gadolinio	KEM
gaja	alegre	
gaji	estar alegre	
gajigi	alegrar	
gajni	ganar	EKON
gajno	ganancia	EKON
galaksio	galaxia	AST, EVI
galanta	galante	
galantino	galantina	KUI
galerio	galería	ARKI, BELA, TEA
galero	galera	FIG, HIS, JUR, MAR, MIL
galicismo	galicismo	LIN
galimatio	galimatías	
galiumo	galio	KEM
galo	bilis	ANA
galopi	galopar	
galopo	galope	FIG, ZOO
galvana	galvánico	ELE
galvanizi	galvanizar	ELE
galvanometro	galvanómetro	ELE
galveziko	vesícula biliar	ANA
gambito	gambito	SPO
gambo	pierna	ANA
gango	ganga	GEOL
gangren(ig)i	gangrenar	
gangreno	gangrena	FIG, MED
ganto	guante	TEKS
garantiaĵo	garantía	EKON, JUR
garantiaĵo	caución	EKON, JUR
garantii	garantizar	
garantio	garantía	FIG
garaĝo	garaje	
gardenio	gardenia	BOT
gargari	hacer gárgaras	FIG
gargojlo	gárgola	ARKI
gaseca	gaseoso	
gaso	gas	FIZ, KOMUNE
gastama	hospitalario	
gast(ig)ema	hospitalario	
gastejo	albergue	
gastigi	albergar	
gasto	huésped	
gastronomio	gastronomía	KUI
gastronomo	gatrónomo	
gastropodoj	gasterópodos	ZOO
gazelo	gacela	ZOO
gazetaro	prensa	
gazetistaro	prensa	
gazetisto	periodista	
gazeto	revista	TIP
gazono	césped	HOR
gaŭsa	gaussiano	
gaŭĉo	gaucho	
geamantoj	amantes	
geja	homosexual	
gejo	homosexual	
gejo	gay	
gejsero	géiser	GEOG
geko	geco	KOMUNE, ZOO
gemo	gema	FIG, MIN
generacio	generación	GEN
generatoro	generador	ELE, TEK
genetiko	genética	BIO
genezo	Génesis	BIB, REL, SCI
genezo	génesis	BIB, REL, SCI
genia	genial	
genio	genio	MIT
genitivo	genitivo	GRA
geno	gen	BIO
geno	gene	BIO
genocido	genocidio	JUR
genro	género	BOT, GRA, LIN, ZOO
geodezio	geodesia	GEOD, SCI
geografo	geógrafo	
geologiisto	geólogo	GEOL
geologio	geología	GEOL, SCI
geologo	geólogo	
geometria	geométrico	MAT
geometriisto	geómetra	
geometrio	geometría	MAT, TEK
georgino	dalia	BOT
gepardo	guepardo	ZOO
geranio	geranio	BOT
gerbilo	jerbo	ZOO
gerilano	guerrillero	MIL
gerilo	guerrilla	MIL
germana	alemán	
germaniumo	germanio	KEM
germano	alemán	
gerundio	gerundio	EVI, GRA
gestadi	gesticular	
gestema	gesticulador	
gesti	hacer gestos	
gesto	gesto	
giganta	gigante	
giganto	gigante	MIT
gilotini	guillotinar	JUR
gilotino	guillotina	
gimnastiki	hacer gimnasia	
gimnastikisto	gimnasta	SPO
gimnastiko	gimnasia	SPO
gimnasto	gimnasta	
gimnazia diplomito	bachiller	
gimnazio	preparatoria	PED
gimnazio	liceo	PED
gimnazio	bachillerato	PED
ginekologiisto	ginecólogo	MED
ginekologio	ginecología	MED
ginekologo	ginecólogo	MED
gingivo	encia	ANA
girlando	guirnalda	
giroskopo	giroscopio	TEK
gitaro	guitarra	MUZ
giĉeto	ventanilla	ARKI
giĉeto	taquilla	ARKI
glaciaro	glaciar	GEOG
glaciejo	glaciar	GEOG
glaciaĵo	helado	KUI
glaciigi	congelar	
glaciinsulo	témpano	GEOG
glacimonto	témpano	GEOG
glaciiĝi	congelarse	
glacio	hielo	
glacipluvo	granizo	MET
glacirompilo	rompehielos	MAR, SPO
glaciujo	hielera	
glaciŝranko	hielera	
glacitenejo	hielera	
gladi	planchar	
gladiatoro	gladiador	HIS
gladilo	plancha	
gladiolo	gladiola	BOT
glando	glándula	ANA
glaso	vaso	
glata	liso, -a	FIG
glata	"sin obstáculos"	FIG
glata	fácil	FIG
glata	gentil	FIG
glata	suave	FIG
glata	dulce	FIG
glatigi	alisar	
glatigi	suavizar	
glatigi	pulir	
glavo	espada	FIG, MIL
glicerino	glicerina	KEM
glicirizo	regaliz	BOT
glita	resbaladizo	FIG
glitiga	resbaladizo	FIG
gliti	deslizarse	FIG
gliti	patinar	FIG
gliti	deslizarse	FIG
gliti	patinar	FIG
gliti	resbalar	FIG
glitilo	patín	
glito	patinaje	FON, POE
glitŝuo	patín	SPO
globo	globo	MAT
globuso	globo	GEOG
glosaro	glosario	
gloso	glosa	TIP
glota plosivo	oclusiva glotal	FON
glugli	gorgotear	
gluglo	gorgoteo	
glui	pegar	FIG, RAR
gluilo	pegamento	
gluo	pegamento	
glutema	tragón	
gluteno	gluten	KEM
gluteo	glúteo	ANA
gluti	tragar	FIG
gluto	bocado	
gnejso	gneis	MIN
gnomo	gnomo	MIT
gnomono	gnomon	AST
golejisto	portero	SPO
golejisto	guardameta	SPO
golejo	portería	SPO
golfeto	bahía	GEOG
golfo	golfo	GEOG
golo	gol	SPO
gondolisto	gondolero	
gondolo	góndola	
gongo	gong	MUZ
gonokoko	gonococo	MED
gorilo	gorila	ZOO
gotika	gótico	TIP
gracia	gracioso, -a	
gracie	graciosamente	
gracie	con gracia	
gracieco	gracia	
graco	gracia	KRI
gradiento	gradiente	FIZ, MAT
gradigi	graduar	
grado	grado	MAT
grafeiko	teoría de grafos	MAT
grafika fasado	Interfaz Gráfica de Usuario	KOMP
grafismo	grafía	LIN
grafito	grafito	KEM
graflando	condado	HIS
grafo	grafo	EVI, MAT
grafo	conde	EVI, MAT
grafologiisto	grafólogo	
grafologio	grafología	
grafologo	grafólogo	
grafujo	condado	
grajlo	aguanieve	MET
grajno	grano	AGR, BOT, FIG
graki	graznar	
graki	tener carraspera	
gramatiko	gramática	GRA, LIN, SCI
gramo	gramo	
gramofono	gramófono	TEK
granato	granada	
granda	grande	
granda duonakso	semi eje mayor	MAT
grandegulo	gigante	
grandiga vitro	lupa	FOT
grandioza	grandioso	
grandnombra	numeroso	
grandvalora	valioso	
granito	granito	MIN
grasa	graso	AGR, TIP
grasa	grasoso	AGR, TIP
graso	grasa	
grateni	gratinar	KUI
gratifiki	gratificar	EKON
gratifiko	gratificación	EKON
gratula	de felicitación	
gratuli	felicitar	
gratulo	felicitación	
grava	importante	
graveda	embarazada	
gravedigi	embarazar	
gravediĝi	quedarse embarazada	
gravediĝi	embarazarse	
gravediĝi	quedarse encinta	
gravi	importar	
gravito	gravedad	FIZ
gravuraĵo	grabado	BELA
gravuri	grabar	FIG
grenadisto	granadero	MIL
grenado	granada	MIL
grimaci	hacer muecas	
grimaco	mueca	
grimpema	trepadora	BOT
grimpi	escalar	BOT
grimpi	trepar	BOT
grinci	rechinar	
grinci	chirriar	
gripo	gripe	MED
griza	gris	
grizo	gris	
groteska	grotesco	KOMUNE
groto	gruta	
grundo	suelo	ARK, FIG
grundo	terreno	ARK, FIG
grunti	gruñir	
gruo	grulla	TEK, ZOO
gruo	grúa	TEK, ZOO
grupeto	grupeto	
grupigi	agrupar	
grupo	grupo	BIO, FON, MAT
grupo	conjunto	BIO, FON, MAT
guano	guano	AGR
gubernatoro	gobernador	POL
gurdo	organillo	MUZ
gurdo	cilindro	MUZ
gusti	gustar	FIG
gusto	sabor	FIG
gusto	gusto	FIG
gustumi	saborear	FIG
gutaperko	gutapercha	KEM
gute	gota a gota	
pogute	gota a gota	
guti	gotear	
guto	gota	FIG
guturalo	gutural	FON
gvardio	guardia	MIL
gvidi	guiar	FIG
gvidisto	guía	POL
gvidlibro	guía	
hadrono	hadrón	FIZ
hafnio	hafnio	KEM
hajlero	granizo	MET
hajli	granizar	FIG, MET
hajlo	granizo	MET
hakilo	hacha	
haleluja	aleluya	REL
halo	salón	ARKI
halogeno	halógeno	KEM
haloo	halo	AST, FOT
hamako	hamaca	
hamstro	hámster	ZOO
hangaro	hangar	AVI
hararo	cabellera	ARK
hararo	pelaje	ARK
hararo	peluca	ARK
hardi	templar	FIG
hardi	endurecer	FIG
harego	cerda	ZOO
haremo	harem	
harfendi	hablar babosadas	KOMUNE
haringo	arenque	ZOO
harligo	trenza	
harmona	armónico	MAT
harmonii	armonizar	
harmoniigi	armonizar	
harmoniko	armonía	MUZ
harmoniko	harmónica	MUZ
harmoniko	acordeón	MUZ
harmonio	armonía	FIG, MUZ, POE
harmono	armónico	MUZ
harniso	arnés	
haro	cabello	ANA, BOT
haro	pelo	ANA, BOT
harpi	tocar el arpa	
harpio	harpía	FIG, MIT, ZOO
harpio	harpía	FIG, MIT, ZOO
harpo	arpa	MUZ
harpuni	arponear	
harpuno	arpón	
harsapo	champú	
hasta	apurado, -a	
hasta	apresurado	
hasta	(hecho, -a) a la carrera	
hasta	apremiado, -a	
hastema	apresurado, -a	
hastema	ajolotado, -a	
hasti	apurarse	
hasti	darse prisa	
hasti	apresurarse	
hasto	apuramiento	
hasto	prisa	
hasto	apresuramiento	
hasto	premura	
hav(aĵ)o	posesión	EKON
haveno	puerto	FIG, MAR
havi	tener	FIG, FRAZ
havigi	proporcionar	
haŭto	piel	ANA
hebrea lingvo	hebreo	LIN
hebreo	Hebreo	
hedero	hiedra	BOT
hegemonio	hegemonía	POL
hej	hey	
hejti	calentar	
hejtilo	calentador	
hekatombo	hecatombe	FIG
heksaedro	hexaedro	MAT
hektaro	hectárea	
hektogramo	hectógramo	
hektolitro	hectolitro	
hektometro	hectómetro	
hela	oscuro	FIG
hela	claro	FIG
hela	brillante	FIG
heleco	claridad	
heleco	luminosidad	
helianto	girasol	BOT
helico	hélice	MAT, TEK
heligi	aclarar	
heliko	caracol	KOMP, ZOO
heliko	arroba	KOMP, ZOO
helikoptero	helicóptero	AVI
heliotropo	heliotropo	BOT, MIN
heliumo	helio	KEM
heliĝi	aclararse	
helpanto	ayudante	
helpisto	ayudante	
helpi	ayudar	
helpo	ayuda	
hematito	hematites	MIN
hemikranio	migraña	MED
hemisfero	hemisferio	AST, EVI, MAT
hemoglobino	hemoglobina	MED
hemoragia	hemorrágico	
hemoragio	hemorragia	MED
heni	relinchar	
hepataĵo	hígado	KUI
hepato	hígado	ANA
heraldiko	heráldica	HER, SCI
herbario	herbario	
herbaĉo	hierba mala	AGR
herbo	hierba	BOT, RAR
hered(aĵ)o	herencia	JUR
heredi	heredar	FIG, JUR, MED
heredigi	heredar	
herezo	herejía	FIG, REL
herezulo	hereje	
hermafrodita	hermafrodita	BIO, MED
hermetika	hermético	TEK
heroaĵo	heroicidad	
heroeco	heroicidad	
heroldo	heraldo	
heroo	héroe	BELE, MIT
herpeto	herpes	BAK, BIO, MED
herso	rastrillo	ARKI, TEK
heterogena	heterogéneo	SCI
heziti	titubear	
heziti	vacilar	
heĝo	seto	HOR
hiacinto	jacinto	BOT
hiato	hiato	FON
hibrida	híbrido	
hibrido	híbrido	BOT, ZOO
hidalgo	hidalgo	
hidrargo	mercurio	KEM
hidrargo	azogue	KEM
hidraŭlika	hidráulico	
hidraŭliko	hidráulica	SCI, TEK
hidro	hidra	MIT, ZOO
hidroaeroplano	hidroavión	ARK, AVI
hidrocefala	hidrosefálico	
hidrocefalo	hidrocefalia	MED
hidroelektra	hidroeléctrica	TEK
hidrofobio	hidrofobia	MED
hidrogeno	hidrógeno	KEM
hidrokarbido	hidrocarburo	KEM
hidrometrio	hidrometría	SCI
hidrometro	hidrómetro	TEK
hidroplano	hidroavión	AVI
hidrostatiko	hidrostática	FIZ
hidroterapio	hidroterapia	MED
hieno	hiena	ZOO
hierarkio	jerarquía	
hierarĥio	jerarquía	
hieratika	hierática	
hieraŭ	ayer	
higiena	higiénico	
higieno	higiene	MED
hiki	tener hipo	
himeno	himen	ANA, BOT
himno	himno	POE, POL, REL
hinda	indio	
hinda	hindú	
hindeŭropa	indoeuropeo	LIN
hindo	indio	
hindo	hindú	
hiperbolo	hipérbola	BELE, MAT
hiperbolo	hipérbole	BELE, MAT
hiperboloido	hiperboloide	MAT
hipertrofio	hipertrofia	MED
hipnota	hipnótico	
hipnotigi	hipnotizar	
hipnotismo	hipnotismo	SCI
hipodromo	hipódromo	SPO
hipogrifo	hipogrifo	MIT
hipopotamo	hipopótamo	ZOO
hipoteki	hipotecar	EKON
hipoteko	hipoteca	EKON
hipotenuzo	hipotenusa	MAT
hipotezi	formular una hipótesis	
hipotezo	hipótesis	
hipoĥondrio	hipocondría	MED, PSI
hipoĥondriulo	hipocondriaco	
hirta	erizado	
hirta	hirsuto	
hirta	híspido	
hirtigi	erizar	
histerio	histeria	FIG, MED, PSI
histo	tejido	ANA
histologio	histología	ANA, FIZL, SCI
historia	histórico	
historia materiismo	materialismo histórico	FIL, HIS, MAH
historiisto	historiador	HIS
historio	historia	HIS, RAR, SCI
hobio	hobby	NEO
hobio	pasatiempo	NEO
hobojo	oboe	MUZ
hodiaŭ	hoy	
hoka	ganchudo, -a	
hoka	curvo	
hoko	garfio	
hoko	gancho	
hoko	anzuelo	
holmio	holmio	KEM
homa	humano	
homama	filántropo	
homaro	humanidad	
homedoj	Homínidos	ZOO
homeopatia	homeopático	FIG
homeopatio	homeopatía	MED
homevitulo	misántropo	
hommanĝulo	antropófago	
homo	hombre	ZOO
homo	humano	ZOO
homologa	homólogo	ANA, ARK, KEM, MAT
homonimo	homónimo	LIN
honesta	honesto	
honorarii	pagar honorarios	EKON
honorario	honorarios	EKON
honori	honrar	
honoro	honor	
honti	avergonzarse de	
hontigi	avergonzar	
hontindaĵo	vergüenza	
honto	vergüenza	
horaro	horario	
horlibro	horario	
hordeo	cebada	AGR, BOT
hordo	horda	FIG, HIS
hore	por hora	
horizontala	horizontal	FIZ, TEK, TIP
horizonto	horizonte	AST, FIG, GEOG
horloĝisto	relojero	
horloĝo	reloj	KAL
hormono	hormona	BOT, FIZL
hormontrilo	manecilla	KAL
horo	honra	KAL
horoskopo	horóscopo	
hospitalo	hospital	EVI, MED
hostio	hostia	KRI
hotelisto	hotelero	
hotelmastro	hotelero	
hotelo	hotel	
hufo	casco	ZOO
hufo	pezuña	ZOO
huligano	hooligan	POL
humero	húmero	ANA
humida	húmedo	EVI, SCI
humoro	humor	ARK, FIG, RAR
humuro	humor	
hundherbo	grama	KOMUNE
hundo	perro	ZOO
hungara	húngaro	
hungaro	húngaro	
huno	huno	HIS
hura	hurra	
iai	rebuznar	
iao	rebuzno	
ideala	ideal	
idealigi	idealizar	
idealismo	idealismo	BELA, EVI, FIL
idealisto	idealista	EVI, FIL
idento-bildigo	función identidad	MAT
ideo	idea	
ideografiaĵo	ideograma	LIN
idiomo	idioma	LIN
idioteco	idiotez	MED
idiotigi	idiotizar	
idioto	idiota	MED
idolano	idólatra	
idolo	ídolo	FIG, REL
ignori	ignorar	
igvano	iguana	ZOO
igvanodonto	iguanodonte	PAL, ZOO
ikonostazo	iconostasio	KRI
ikso	equis	TIP
iktero	ictericia	ARK, MED
ileo	íleon	ANA
ili	ellos	
ili	ellas	
iliumo	ilion	ANA
iluminado	iluminación	
ilumini	iluminar	
ilustraĵo	ilustración	
ilustri	ilustrar	FIG
iluzii	ilusionar	
iluziisto	ilusionista	TEA
iluziiĝi	ilusionarse	
iluzio	ilusión	
imaga	imaginario	
imagema	imaginativo	
imagi	imaginar	
imago	imaginación	
imagado	imaginación	
imanenta	inmanente	FIL
imiti	imitar	
imiti	reproducir	
imiti	hacer una reproducción	
impedanco	impedancia	ELE, FIZ
imperativo	imperativo	FIG, GRA
imperia	imperial	
imperialismo	imperialismo	
imperialisto	imperialista	
imperiestro	emperador	
imperiismo	imperialismo	MAH
imperiisto	imperialista	
imperio	imperio	FIG
impertinenta	impertinente	
impeta	impetuoso	
impeto	ímpetu	FIG
implikacio	implicación	MAT
importado	importación	EKON
importaĵo	importación	EKON
importi	importar	EKON
importisto	importador	EKON
importo	importación	EKON
impostdeklaro	declaración de impuestos	EKON
impostevitulo	evasor de impuestos	EKON
imposti	gravar con impuesto	EKON
imposto	impuesto	EKON
impotenta	impotente	MED
impresa	impresionante	
impresi	impresionar	
impresionismo	impresionismo	BELA
impresionisto	impresionista	BELA
impreso	impresión	FOT
improvizaĵo	improvisación	
improvizi	improvisar	
improvizisto	improvisador	
impulsema	impulsivo	
impulsi	impulsar	
impulsiĝema	impulsivo	
impulso	impulso	ELE, EVI, FIZ
imputi	imputar	EKON
imuna	inmune	JUR, MED
imuneco	inmunidad	
imunigi	inmunizar	
inaŭguracio	inaguración	
inaŭguri	inaugurar	
inaŭguro	inaguración	
inaŭgurado	inaguración	
incendio	incendio	
incenso	incienso	FIG
incesto	incesto	JUR
incidento	incidente	
incidi	incidir	FOT
inciteco	incitación	
inciti	irritar	FIG, POE
inciti	incitar	FIG, POE
incito	incitación	RAR
incizivo	incisivo	ANA
indekso	índice	KAT, TIP
indiano	indio	
indiferenta	indiferente	
indiferente	indiferentemente	
indigni	indignar	
indigno	indignación	
indigo	índigo	
indikativo	indicativo	LIN
indikatoro	medidor	TEK
indiki	indicar	
indikilo	indicador	
indiko	indicación	
indio	indio	KEM
individua	individual	
individualismo	individualismo	
individualisto	individualista	
individueco	individualidad	
individuismo	individualismo	
individuisto	individualista	
individuo	individuo	
indiĝena	indígena	
indiĝeno	indígena	
indukta	inductivo	
indukti	inducir	ELE
indukto	inducción	ELE, MAT
indulgenco	indulgencia	KAT
industria	industrial	
industriisto	industrial	
industriulo	industrial	
industrio	industria	
inercia	inercial	
inercio	inercia	FIZ
inerciuma	inercial	
inerta	inerte	FIG, KEM
inerteco	inercia	FIG, FIZ
inerto	inercia	FIG, FIZ
inertoforto	fuerza de inercia	FIZ
infana	infantil	
infano	niño	GEN
infanterio	infantería	MIL
infekti	infectar	FIG, MED
infekto	infección	MED
infektado	infección	MED
infera	infernal	FIG
infero	infierno	FIG, FRAZ, KRI, REL
infinita	infinito	ARK, MAT
infinitivo	infinitivo	GRA
infinitiĝi	tender al infinito	MAT
infinito	infinito	ARK, MAT
inflacio	inflación	EKON
inflami	estar inflamado	MED
inflamigi	inflamar	MED
inflamo	inflamación	MED
infleksa	de inflexión	MAT
infloresko	inflorescencia	BOT
influa	influyente	
influi	influir	
influo	influencia	
informa	informativo	
informi	informar	
informisto	informador	
informiĝi	informarse	
informo	información	KOMP
infuzaĵo	infusión	KUI, MED
ingenro	género femenino	GRA
ina genro	género femenino	GRA
ingoto	lingote	
ingredienco	ingrediente	
inhali	inhalar	MED
inhalilo	inhalador	
inici	iniciar	
iniciatemo	iniciativa	
iniciati	iniciar	
iniciatinto	iniciador	
iniciato	iniciativa	
inismo	feminismo	
injekti	inyectar	MED, TEK
injektilo	jeringa	MED, TEK
injekto	inyección	
injektoro	inyector	TEK
inkandeska	incandescente	
inkandeski	incandecer	FIZ, TEK
inkandesko	incandescencia	
inkludi	incluir	
inkluziva	incluido	
inkluzivi	incluir	MAT
inko	tinta	
inkognito	incógnito	
inkrustaĵo	incrustación	BELA
inkrusti	incrustar	
inkubacio	incubación	MED
inkubatoro	incubadora	AGR, BIO, MED
inkubo	pesadilla	KAT
inkudo	yunque	ANA
inkujo	tintero	
inkvizicio	inquisición	HIS, KAT
inkvizitoro	inquisidor	HIS, KAT
inokuli	inocular	ARK, BOT, FIG, MED
insekto	insecto	
insektoj	insectos	ZOO
insektomanĝuloj	insectívoros	ZOO
insigno	insignia	HER
insista	insistente	
insistema	insistente	
insisti	insistir	
inspektanto	inspector	
inspektisto	inspector	
inspekti	inspeccionar	
inspektoro	inspector	
inspiri	inspirar	
inspiro	inspiración	
instalado	instalación	
instalaĵo	instalación	
instali	instalar	
instalilo	programa de instalación	KOMP
instalilo	instalador	KOMP
instalisto	instalador	TEK
instanco	instancia	JUR, POL
instigi	instigar	
instinkto	instinto	
institucio	instutución	
instituto	instituto	
instruado	enseñanza	PED
instruaĵo	enseñanza	
instruejo	escuela	PED
instrui	enseñar	FIG, PED
instruisto	profesor	PED
instrukcio	instrucciones	KOMP
instrukcio	comando	KOMP
instrumento	instrumento	TEK
insulano	isleño	
insularo	archipiélago	GEOG
insulino	insulina	KEM, MED
insulo	isla	GEOG
insulti	insultar	
insulto	insulto	
integrala	integral	MAT
integralado	integración	MAT
integrali	integrar	MAT
integralo	integral	MAT
intelekta	intelectual	
intelekto	intelecto	
intelekto	inteligencia	
intelektulo	inteligente	
inteligenta	inteligente	
inteligenteco	inteligencia	
inteligento	inteligencia	
intendanto	intendente	
intensa	intenso	
intenseco	intensidad	
intensigi	intensificar	
interago	interacción	KOMP
interakto	entreacto	TEA
interezo	interés	EKON, JUR, MAH
interfratiĝi	fraternizar	
interjekcio	interjección	GRA
interkonformigi	casar	
interkonformigi	entrecasar	
interkonformigi	hacer coincidir	
interlingvistiko	interlingüística	LIN
intermonto	paso	GEOG
montpasejo	paso	GEOG
interna	interno	FIG, MAT
internacia	internacional	
internacia respondkupono	cupón de respuesta internacional	POSX
internaĵo	entrañas	
interne	internamente	
internigi	internar	
internulo	interno	
interpelacii	interpelar	
interpelacio	interpelación	POL
interplekti	entrelazar	
interpoli	interpolar	BELE, MAT
interpreti	interpretar	
interpreti	interpretar	
interpretilo	intérprete	KOMP
interpretisto	intérprete	
interpreto	interpretación	
interpunkcii	puntuar	TIP
interpunkcio	puntuación	TIP
intersekvo	secuencia	
intersekvo	serie	
sinsekvo	secuencia	
sinsekvo	serie	
intervalo	intervalo	MAT, MUZ
intervjui	entrevistar	
intervjuo	entrevista	
interŝanĝi	intercambiar	
intesto	intestino	ANA
intima	íntimo	
intimeco	intimidad	
intimulo	amigo íntimo	
intrigi	intrigar	
intrigo	intriga	BELE
introspekto	introspección	FIL, PSI
intuicia	intuitivo	
intuicio	intuición	
inuita	esquimal	
inuito	esquimal	
inundi	inundar	
invadi	invadir	
invado	invasión	
invalideco	invalidez	
invalido	inválido	
inventari	inventariar	
inventaro	inventario	EKON
inventaĵo	invento	TEK
inventi	inventar	TEK
inventisto	inventor	
invento	invención	
inversa	inverso	MAT
inversa bildigo	función inversa	MAT
inverse	inversamente	
inversigebla	invertible	MAT
inversigi	invertir	MAT
inversio	inversión	GRA
inversio	hipérbaton	GRA
investaĵo	inversión	EKON
investi	invertir	ARK, EKON, FIG, RAR
inviti	invitar	
invito	invitación	KOMP
involucio	involución	MAT
inĝeniero	ingeniero	
io	algo	
iri	ir	FIG
iridio	iridio	KEM
irigacii	irrigar	
irigacio	irrigación	AGR
iriso	iris	ANA
iriti	irritar	MED, POE
irlanda	irlandés	
ironia	irónico	
ironio	ironía	
iskiatalgio	ciática	MED
islamano	musulmán	REL
islamismo	islamismo	POL
islamisto	islamita	POL
islamo	islam	ISL, REL
istmo	istmo	GEOG
italo	Italiano, Italiana	
iterbio	iterbio	KEM
itrio	itrio	KEM
iu	alguien	
iu	algún	
iu	algún	
iusence	en cierto sentido	
izocela	isósceles	MAT
izola	aislado	
izoli	aislar	ELE, KEM
izometria	isométrico	MAT
izometrio	isometría	MAT
izomorfia	isomorfo	MAT
izomorfio	isomorfismo	MAT
izoterma	isotermo	FIZ, GEOG
izotermo	isoterma	
izotopa	isotópico	FIZ, KEM
izotopo	isótopo	FIZ, KEM
izotropa	isotrópico	FIZ
ja	ciertamente	
ja	efectivamente	
jado	jade	MIN
jaguaro	jaguar	ZOO
jahurto	yogur	KUI
jakobeno	jacobino	POL
jam	ya	
jambo	yambo	POE
januaro	enero	KAL
jarcento	siglo	KAL
jardo	yarda	MAR
jardo	verga	MAR
jarlibro	anuario	
jarmilo	milenio	
jaro	año	AST, KAL
jaspo	jaspe	MIN
jaĥto	yate	MAR
jen	he aquí	
jen... jen...	a veces ... a veces...	
jes	sí	
jesa	afirmativo	
jesi	afirmar	
jezuito	jesuita	FIG, REL
jeĵuri	conjurar	
kunĵuri	conjurar	
jodo	yodo	KEM
jodoformo	yodoformo	KEM
jogurto	yogur	KUI
jonigi	ionizar	ELE, FIZ, KEM
jonizi	ionizar	ELE, FIZ, KEM
jono	ión	ELE, FIZ, KEM
jordania	jordano	
jordaniano	jordano	
joviala	jovial	RAR
jovialeco	jovialidad	RAR
jubileo	jubileo	
jubilo	júbilo	
judaismo	judaísmo	
judismo	judaísmo	REL
judo	judío	REL
jugi	subyugar	FIG
jugo	yugo	FIG
juki	picar	
juko	picor	
julio	julio	KAL
juna	joven	
juneco	juventud	FIG
junio	junio	
juniperbrando	ginebra	KUI
junipero	enebro	BOT
junkacoj	juncáceas	BOT
junko	junco	BOT
junto	junta	TEK
jupo	falda	TEKS
jura	jurídico, -a	JUR
jura	legal	JUR
jurisdikcio	jurisdicción	JUR
juristo	jurisconsulto	JUR
juristo	jurista	JUR
juro	derecho	JUR
juvelejo	joyería	
juvelisto	joyero	
juvelo	joya	BELA, FIG
juĝi	juzgar	JUR
juĝisto	juez	JUR
juĝo	juicio	
kabano	cabaña	
kabano	choza	
kabineto	gabinete	POL
kabla televido	televisión por cable	TEL
kablo	cable	ARK, ELE, MAR, TEK, TEL
kablo	cable	ARK, ELE, MAR, TEK, TEL
kablo	Cable	ARK, ELE, MAR, TEK, TEL
kablo	Televisión por cable	ARK, ELE, MAR, TEK, TEL
kabo	cabo	GEOG
kabrioleto	descapotable	AUT, TRA
kabrioleto	convertible	AUT, TRA
kaco	polla	ANA, VULG
kadavro	cadáver	
kadenco	cadencia	MUZ
kadeto	cadete	MIL
kadio	cadí	ISL
kadmio	cadmio	KEM
kadre de	en el marco de	
kadri	enmarcar	
kadro	marco	
kadro	cuadro	
kadro	marco	
kaduceo	caduceo	MIT
kafeino	cafeína	KEM, MED
kafejo	cafetería	
kafkruĉo	cafetera	
kafo	café	BOT, KUI
kaj	y	
kajo	muelle	FER, KOMP, MAR, MAT
kajo	andén	FER, KOMP, MAR, MAT
kajto	cometa	SPO, TEK
kajto	papalote	SPO, TEK
kakaarbo	cacao	BOT
kakaoarbo	cacao	BOT
kakao	cacao	BOT, KUI
kakatuo	cacatúa	ZOO
kakaujo	cacao	BOT
kakofonio	cacofonía	MUZ, RAR
kakto	cactus	BOT
kakto	cacto	BOT
kalandro	calandria	ZOO
kalcini	calcinar	
kalcio	calcio	KEM
kaldronego	caldera	TEK
kaldrono	caldero	GEOG, KUI
kalejdoskopo	caleidoscopio	SPO
kalendaro	calendario	KAL
kalendo	calenda	KAL
kalendulo	caléndula	BOT
kalfatri	calafatear	MAR
kalibri	calibrar	
kalibrigi	calibrar	
kalibro	calibre	TEK
kalifo	califa	HIS, ISL, POL, REL
kalifornio	californio	GEOG, KEM
kaliforniumo	californio	KEM
kalikoto	calicó	TEKS
kalio	potasio	KEM
kalkaneo	calcáneo	ANA
kalkano	talón	ANA
kalkuli	calcular	
kalo	callo	MED
kalorio	caloría	FIZ
kalsono	calzón	TEKS
kalumnii	calumniar	
kalumnio	calumnia	
kalva	calvo	FIG
kalvaria vojo	calvario	FIG, KRI
kalvinano	calvinista	KRI
kalvinismo	calvinismo	KRI
kamarilo	camarilla	
kambio	letra de cambio	EKON
kambrio	cámbrico	GEOL
kameleono	camaleón	ZOO
kamelo	camello	ZOO
kameno	chimenea	
kameo	camafeo	BELA, TEK
kamerlingo	camarlengo	KAT
kamioneto	camioneta	AUT
kamiono	camión	AUT
kamomilo	manzanilla	BOT
kampadejo	campamento	
kampanilo	campanario	ARKI
kampanjo	campaña	
kamparano	campesino	AGR
kampulo	campesino	AGR
kampi	acampar	
kampo	campo	AGR, KOMP, KOMUNE, MAT
kamufli	camuflar	MIL
kanajlo	canalla	
kanalizi	canalizar	
kanalo	canal	ANA, BOT, FIG, GEOG, KOMP
kanario	canario	ZOO
kanceliero	canciller	POL
kancero	cáncer	MED
kandelabro	candelabro	
kandelingo	candelero	
kandelo	vela	
kandidato	candidato	KRI
kanguruo	canguro	ZOO
kanibalo	caníbal	KOMUNE, ZOO
kanino	canino	ANA
kanjono	cañon	GEOG
kankro	acamaya	ZOO
kano	caña	BOT
kanona	canónico	BIB, KRI, MAT
kanoni	cañonear	MIL
kanoniko	canónigo	KAT
kanonizi	canonizar	
kanono	cañón	BIB, KRI, MIL, REL
kanono	canon	BIB, KRI, MIL, REL
kantado	canto	
kantato	cantata	MUZ
kantaĵo	canción	MUZ
kantaĵo	canto	MUZ
kanteti	tararear	MUZ
kanti	cantar	FIG, MUZ
kantiko	cántico	MUZ, REL
kantino	cantina	
kanto	canto	POE
kantoro	cantor	MUZ, REL
kanulo	cánula	MED
kaolino	caolín	KEM
kaosa	caótico	
kaose	caóticamente	
kaoso	caos	
kapabla	capaz	
kapableco	capacidad	
kapablo	capacidad	
kapacitanco	capacitancia	ELE
kapacito	capacidad	ARK, ELE, FIZ, SCI
kapacito	capacitancia	ARK, ELE, FIZ, SCI
kapelo	capilla	KRI, MUZ
kapilara	capilar	
kapilareco	capilaridad	FIZ
kapilaro	capilar	FIZL
kapitalisto	capitalista	EKON
kapitalo	capital	EKON
kapitano	capitán	MAR, MIL
kapitelo	capitel	ARKI
kapitulaci	capitular	FIG
kapo	cabeza	ANA, BOT, GEOG
kapo	cabeza	ANA, BOT, GEOG
kapo	cabeza	ANA, BOT, GEOG
kapono	capón	FIG, KUI
kaporo	alcaparra	BOT, KUI
kapoto	capó	AUT, TEKS
kapoto	cofre	AUT, TEKS
kapreolo	corzo	ZOO
kaprica	caprichoso	
kaprice	caprichosamente	
kaprico	capricho	
kapriolo	cabriola	SPO
kapro	cabra	ZOO
kapstano	cabrestante	MAR, TEK
kapsulo	cápsula	BOT, KEM, MED, TEK
kapti	capturar	FIG
kaptilo	trampa	
karabeno	carabina	MIL
karafo	garrafa	
karakteriza polinomo	polinomio característico	MAT
karamelo	caramelo	KUI
karateo	kárate	SPO
karavano	caravana	ESP
karavelo	carabela	SHI
karbo	carbón	
karbono	carbono	KEM
kardinala moŝto	eminencia	KAT
kardinalo	cardenal	KAT, MAT
kardio	cardias	ANA
kareo	curry	KUI
karikaturo	caricatura	
karmezina	carmesí	
karmezino	carmesí	
karoto	zanahoria	BOT, KUI
kartelo	cártel	EKON, JUR, POL
kartezia produto	producto cartesiano	MAT
kartilago	cartílago	ANA
kartono	cartón	
kartoĉo	cartucho	MIL, SPO
karuselo	carrusel	SPO
kasedo	casete	FOT, KOMP, TEK
kaserolo	cacerola	KUI
kaserolo	cazo	KUI
kaskado	cascada	FIG, TEK
kasko	casco	MIL
kastri	castrar	
katafalko	catafalco	
katakombo	catacumba	
katalepsio	catalepsia	MED
katalogi	catalogar	
katalogo	catálogo	
kataplasmo	cataplasma	MED
katapulti	catapultar	
katapulto	catapulta	AVI, HIS, MIL, TEK
katarakto	catarata	EVI, MED, RAR
kataro	catarro	MED
katastro	catastro	JUR
katastrofo	catástrofe	
katedralo	catedral	
katekismo	catecismo	
katekisto	catequista	REL
kateto	cateto	MAT
kateĥizi	catequizar	REL
kateĥizisto	catequista	REL
kateĥizo	catequesis	REL
katodo	electrodo negativo	ELE
katodo	cátodo	ELE
kavernhomo	cavernícola	PRA
kaviaro	caviar	KUI
kazako	casaca	TEKS
kazeino	caseína	KEM
kazeo	requesón	KUI
kazo	caso	LIN
kazuistiko	casuística	REL
kazuisto	casuista	REL
kaĉaloto	cachalote	ZOO
kaĝo	jaula	
kaŝe	a escondidas	
kaŝejo	escondite	
kaŝi	ocultar	
kaŝi	esconder	
kaŝludo	escondidillas	SPO
kaŝludo	escondelero	SPO
kaŝnomo	seudónimo	
kaŝobservi	espiar	
kaŭcio	fianza	EKON, JUR
kaŭstika	caústico	KEM, MED
kaŭstika	corrosivo	KEM, MED
kaŭterizi	cauterizar	MED
kaŭterizilo	cauterio	
kecalo	quetzal	EKON, ZOO
kefiro	kéfir	KUI
keglo	bolo	
kekso	galleta	KUI
kelisto	bodeguero	
kelnero	mesero	
kelo	bodega	FIG
kelo	despensa	FIG
kelo	almacén	FIG
kelta	céltico	
kelto	celta	
kemio	química	
kerna	nuclear	FIG
kerno	núcleo	BOT, FIG, KOMUNE, MAT
kerubo	querubín	ARKI, BIB, FIG, KAT
kilo	quilla	MAR
kilogramo	kilogramo	FIZ
kilokalorio	kilocaloría	FIZ
kilometro	kilómetro	
kilovolto	kilovoltio	ELE
kilto	kilt	TEKS
kimono	quimono	TEKS
kinematiko	cinemática	FIZ, MAT
kinino	quinina	BIO, MED
kirasi	acorazar	
kirasi	blindar	
kiraso	coraza	MIL, ZOO
kirli	batir	
kisi	dar un beso	FIG
kisi	besar	FIG
kisi	acariciar	FIG
kiso	beso	
kitaro	cítara	MUZ
klano	clan	
klara	claro	
klare	claramente	
klarigi	aclarar	
klariono	clarín	MIL, MUZ
klarmensa	lúcido	PSI
klarneto	clarinete	MUZ
klasifiki	clasificar	
klasifiko	clasificación	
klasika	clásico	BELA, HIS
klasikaĵo	clásico	
klasikismo	clasicismo	
klasikulo	clásico	
klavaro	teclado	KOMP
klavceno	clavicordio	MUZ
klavi	teclear	
klavikordo	clavicordio	MUZ
klavo	tecla	
klaĉi	chambrear	
klaĉi	chambriar	
klaĉi	chismorrear	
klaĉi	chismear	
klaĉo	chisme	
klaĉo	chambre	
klaŭno	payaso	
klaŭstro	claustro	ARKI, KRI
klaŭzo	cláusula	EKON, JUR
kleo	clave	MUZ
kleriko	clérigo	REL
klifo	acantilado	GEOG
klimakso	clímax	BELE
klimato	clima	MET
klingo	cuchilla	
klingo	hoja	
kliniko	clínica	MED
klinko	picaporte	TEK
klitoro	clítoris	ANA
kloni	clonar	BIO
klonika	clónico	MED
klono	clon	BIO, KOMP, MED
klono	clon	BIO, KOMP, MED
kloro	cloro	KEM
kloroformo	cloroformo	KEM, MED
klostro	claustro	ARKI, KRI
klostrofobio	claustrofobia	MED
klubejo	club	
klubo	club	
kluki	cacarear	
kluzo	esclusa	KOMP, MAR
kluzo	pasarela	KOMP, MAR
knabino	chica	
knabo	chico	
koaguli	coagular	MED
koaguliĝi	coagular	MED
koaguliĝi	coagularse	MED
kobalto	cobalto	KEM
kodekso	códice	JUR, MED, TIP
kodekso	farmacopea	JUR, MED, TIP
kodicilo	codicilo	JUR
kodranto	cuadrante	EKON
koeficiento	coeficiente	KOMUNE, MAT
kojlo	colon	ANA
kojnodento	colmillo	ANA
kojna dento	colmillo	ANA
kokcigo	coxis	ANA
koketa	coqueta	
koketi	coquetear	
koko	Gallo (vira koko), gallina (por kokino)	AGR, ZOO
kokri	ser infiel	
kokri	poner los cuernos	
kokrito	cornudo	
koksalgio	coxalgia	MED
kokso	cadera	ANA
kolbaso	salchicha	KUI
kolbo	culata	MIL, SPO
kolesterolo	colesterol	BIO, KEM
kolhararo	melena	
kolhararo	crin	
kolharoj	melena	
kolharoj	crin	
kolibro	colibrí	ZOO
koliko	cólico	MED
kolirio	colirio	MED
koloida	coloidal	
koloido	coloide	KEM
kolono	colón	ARKI, MIL, RAR, TIP
koloraturo	coloratura	MUZ
kolosa	colosal	
koloso	coloso	
kolostro	calostro	ANA
koltuko	bufanda	TEKS
kolubro	culebra	ZOO
komandoro	comandante	
komao	coma	MUZ
komata	comatoso	
komato	coma	MED
kombi	peinar	
kombilo	peine	
kombinado	combinación	
kombinatorikaĵo	combinación	MAT
kombinatoriko	combinatoria	MAT
kombini	combinar	KEM
komenci	comenzar	
komerca	comercial	EKON
komercaĵo	mercancía	EKON
komerci	comerciar	EKON
komercisto	comerciante	
komerco	comercio	EKON
kometo	cometa	AST
komikeco	cómico	
komisii	comisionar	
komisiisto	comisionado	EKON
komisio	comisión	ARK
komisipago	comisión	EKON
komitato	comité	
kompanio	compañía	EKON, EVI, HIS, JUR, MIL
kompaniulo	acompañante	RAR
komparacio	comparación	GRA
komparado	comparación	GRA
kompaso	compás	
kompendio	compendio	
kompilaĵo	compilación	
kompili	compilar	
kompilo	compilación	
kompleksio	complexión	MED
komplemento	complemento	GRA, MAT
kompletiva	completiva	GRA
komponi	componer	EVI, GRA, KEM, MUZ, RAR
komponisto	compositor	
komposti	componer	TIP
kompoto	compota	KUI
kompozicio	composición	MUZ
kompozito	material compuesto	KEM
komprenaĵo	noción	SCI
komprenebla	comprensible	
komprenebla	entendible	
komprenebla	inteligible	
kompreneble	por supuesto	
kompreneble	por descontado	
kompreneble	comprensiblemente	
komprenema	comprensivo	
komprenemo	afán de aprender	
komprenemo	comprensión	
komprenemo	indulgencia	
kompreni	entender	EVI, RAR
kompreni	comprender	EVI, RAR
komprenigi	hacer entender	
kompreno	comprensión	
kompreso	compresa	MED
komputa sistemo	sistema de computo	KOMP
komputado	cómputo	KOMP
komputi	computar	KOMP
komputika	informático	
komputiko	informática	KOMP
komputilo	ordenador	KOMP
komputilo	computador	KOMP
komputilo	computadora	KOMP
komuna	común	
komuna	común	
komuna	popular	
komunaĵo	intersección (de conjuntos)	MAT
komune	comúnmente	
komune	popularmente	
komuneco	comunidad	
komuneco	"comunidosidad"	
komunii	dar la comunión	
komuniiĝi	comulgar	
komunio	comunión	KRI
komunismo	Comunismo	EKON, MAH
komunisto	comunista	
komunuma	comunal	
komunuma	de la comunidad	
komunuma	comunitario	
komunumo	comunidad	POL
komunumo	comunidad	POL
komunuza	de uso común	
komunuza	de uso popular	
koncentrejo	campo de concentración	
koncepta	conceptual	
koncepta	de concepto	
konceptado	concepción	
konceptebla	concebible	
koncepti	concebir	EVI, TEK
koncepto	concepto	FIL
koncerto	concierto	FIG, MUZ
koncesii	conceder	EKON, JUR
koncesio	concesión	EKON, JUR
koncesiulo	concesionario	EKON, JUR
koncilio	concilio	KRI
koncipi	concebir	
koncipi	quedar embarazada	
koncipo	concepción	
konciza	conciso, -a	
konciza	lacónico, -a	
koncizeco	concisión	
koncizeco	laconicidad	
kondensatoro	condensador	ELE, FOT
kondicionalo	condicional	GRA
kondolenci	condoler	
kondolenci	condolecerse	
kondolenci	dar el pésame	
kondolenco	pésame	
kondolenco	condolencia	
kondomo	preservativo	MED
kondomo	condón	MED
kondomo	profiláctico	MED
kondomo	goma	MED
kondoro	cóndor	ZOO
konduktanco	conductancia	ELE, FIZ
konduti	portarse	
konduti	comportarse	
konduto	comportamiento	
konekti	conectar	ELE, KOMP, TEK
konektilo	conector	ELE, KOMP, TEK
konektilo	enchufe	ELE, KOMP, TEK
konektilo	puerto	ELE, KOMP, TEK
konektite	conectado, -a	KOMP
konektite	en linea	KOMP
konekto	conexión	
konferenco	conferencia	
konfesejo	confesionario	KAT
konfesi	confesar	REL
konfesi	confesar	REL
konfeso	confesión	EVI
konfirmi	confirmar	JUR, KRI
konfiski	confiscar	JUR
konfitaĵo	confite	KUI
konfiti	confitar	KUI
konforma	conforme	MAT
konforma	conrrespondiente	MAT
konforma	concordante	MAT
konforme al	conforme a	
konforme al	conrrespondiente a	
konforme al	concordante con	
konformeco	conformidad	
konformeco	conrrespondencia	
konformeco	concordancia	
konformi	estar o ser conforme	
konformi	ser conrrespondiente	
konformi	ser concordante	
konformigi	volver conforme	
konformigi	hacer conrresponder	
konformigi	hacer concordar	
alkonformigi	volver conforme	
alkonformigi	hacer conrresponder	
alkonformigi	hacer concordar	
konfronti	confrontar	JUR
konfronto	confrontación	JUR
konfuceanismo	Confucianismo	FIL, REL
konfuza	confuso	
konfuzi	confundir	
konfuzo	confusión	
kongesta	congestivo	
kongesti	congestionar	
kongesto	congestión	MED
konglomerato	conglomerado	
konjako	coñac	KUI
konjekti	hacer una conjetura	
konjekti	conjeturar	
konjekti	presumir	
konjekti	suponer	
konjekto	conjetura	MAT
konjekto	suposición	MAT
konjunkcio	conjunción	GRA, MAT
konjunktivito	conjuntivitis	MED
konjunktivo	conjuntiva	ANA, LIN
konjunktivo	subjuntivo	ANA, LIN
konjunkturo	coyuntura	EKON
konkava	cóncavo	MAT
konkava	cóncavo	MAT
konkeri	conquistar	FIG
konklavo	cónclave	KAT
konkoido	concoide	MAT
konkordato	concordato	POL
konkordo	concordia	
konkubino	concubina	
konkur(ad)o	competición	
konkurenco	competencia	EKON
konkuri	competir	
konkursi	concursar	
konkurso	concurso	
konoido	conoide	MAT
konscienco	conciencia	FIL
konservativa	conservador	POL
konservativismo	conservadurismo	POL
konservativulo	conservador	POL
konservatorio	conservatorio	MUZ
konservisma	conservador	POL
konservismo	conservadurismo	POL
konsilanto	consejero	
konsili	aconsejar	
konsilistaro	consejo	
konsilisto	consejero	
konsilo	consejo	ARK, EVI
konsistorio	consistorio	KAT
konsoli	consolar	
konsolo	consuelo	
konsonanta	consonántico	FON
konsonanto	consonante	FON
konstanta	constante	MAT
konstanta kurento	corriente continua	ELE
konstati	constatar	
konstruarto	arquitectura	ARKI
konstrui	construir	FIG, GRA, KON
konsulejo	Consulado	POL
konsulo	Cónsul	HIS, POL
konsulti	consultar	
konsultiĝa	de consulta	
konsultiĝa	consultor, consultora	
kontenero	contenedor	EKON
kontenta	contento	
kontenta	satisfecho	
kontentigi	contentar	
kontentigi	satisfazer	
kontentiĝi	contentarse	
kontesti	cuestionar	
kontingento	contingente	
kontinua	continuo, -a	MAT
kontinueco	continuidad	
kontinuega	continuidad uniforme	MAT
kontinui	ser continuo, -a	
kontinuigi	"continuizar"	
kontrabandaĵo	contrabando	
kontrabandaĵo	mercancía de contrabando	
kontrabandi	contrabandear	
kontrabandisto	contrabandista	
kontrabando	contrabando	EKON, JUR
kontrabaso	contrabajo	MUZ
kontralto	contralto	MUZ
kontrapunkto	contrapunto	MUZ
kontraŭkoncipa	anticonceptivo	MED
kontraŭkoncipa	contraceptivo	MED
kontraŭkoncipilo	anticonceptivo	MED
kontraŭkoncipilo	contraceptivo	MED
kontraŭleĝa	ilegal	JUR
kontraŭpartiklo	antipartícula	FIZ
antipartiklo	antipartícula	FIZ
kontraŭpezi	hacer de contrapeso	
kontraŭpezo	contrapeso	
kontraŭprotono	antiprotón	FIZ
antiprotono	antiprotón	FIZ
kontribuanto	colaborador	
kontribuisto	colaborador	
kontribuaĵo	contribución	
kontribui	contribuir	
konturo	contorno	
kontuzi	contusionar	MED
kontuzo	contusión	MED
konuso	cono	MAT
konuso	superficie cónica	MAT
konvaleski	estar convaleciente	MED
konvaleski	convalecer	MED
konvena	conveniente	
konvencia	convencional	
konvencio	convención	HIS, JUR, POL
konvene	convenientemente	
konveneco	conveniencia	
konveni	ser conveniente	
konversacii	conversar	
konversacii	charlar	
konversacii	platicar	
konversacio	conversación	
konversacio	charla	
konversacio	plática	
konverĝa	convergente	MAT
konverĝi	convergir	MAT
konvinki	convencer	
koordinata akso	eje de coordenadas	MAT
koplo	copla	POE
kopulacii	copular	
kopulacio	copulación	BIO, BOT, ZOO
kora	cordial	
koramikino	novia	
koramiko	novio	
korbelo	ménsula	ARKI
korbo	cesta	SPO
kordinstrumento	instrumento de cuerdas	MUZ
kordo	cuerda	MUZ
kordobo	córdoba	
korekta	correcto	
korekti	corregir	
korektisto	corrector	
korekto	corrección	
korelativa	correlativo	
korespondi	mantener correspondencia	
korfavori	compadecerse de	
koridoro	corredor	ARKI, AVI, EKOL, EVI, FIG, GEOL, POL, TRA
korko	corcho	
korko	corcho	
kormorano	cormorán	ZOO
korneo	córnea	ANA
korneto	corneta	MUZ
korno	cuerno	BIB, FIG, MUZ
koro	corazón	ANA
korodi	corroer	KEM
korolo	corola	BOT
korporaciema	corporativista	
korporacio	corporación	EKON, JUR
korpulenta	corpulento	
korpusklo	corpúsculo	SCI
korseto	corsé	TEKS
korupti	sobornar	EKON
korupti	corromper	EKON
korveto	corbeta	HIS, MAR, MIL, ZOO
korvo	cuervo	ZOO
kosekanto	cosecante	MAT
kosmogonio	cosmogonía	
kosmografio	cosmografía	
kosmologio	cosmología	SCI
kosmopolitismo	cosmopolitismo	POL
kosmopolito	cosmopolita	
koterio	camarilla	
koterio	argolla	
kotizi	contribuir	EKON
kotizo	contribución	EKON
kotizo	cuota	EKON
kotleto	chuleta	KUI
kovarianco	covarianza	MAT
koverto	sobre	POSX
kovi	incubar	FIG
kovilo	incubadora	AGR, BIO, MED
kovri	cubrir	
kovrilo	tapa	FIG
kovrilo	cubierta	FIG
kovrilo	manta	FIG
kovrilo	colcha	FIG
kovrilo	cobertor	FIG
kovrilo	portada	FIG
kovrilo	cubierta	FIG
koŭtoŭi	postrar	
koŭtoŭi	postrarse	
kralo	corral	AGR
kramfo	rampa	MED
krampi	grapar	FIG
krampilo	grapadora	
krampo	grapa	MAT, TIP
kratero	cráter	GEOL, HIS
kravato	corbata	TEKS
kraĉaĵo	escupidura	FIZ
kraĉaĵo	escupitajo	FIZ
kraĉi	escupir	
kraĉujo	escupidera	
kreditoro	acreedor	EKON
kremo	nata	FIG, KUI
kreolo	criollo	
kreozoto	creosota	
krepo	crepé	TEKS
kreso	mastuerzo	
kreso	berro	
kresto	cresta	
kretaceo	cretácico	GEOL
kreteno	cretino	FIG
krevaĵo	quebradura	
krevaĵo	ruptura	
krevi	quebrarse	FIG
krevi	romperse	FIG
krevigi	quebrar	
krevigi	romper	
kribri	colar	
kribrilo	colador	
kriketo	cricket	SPO
krima	criminal	
krima	criminal	
krimi	cometer un crimen	
kriminala	criminal	JUR
kriminalisto	criminalista	JUR
krimo	crimen	JUR
krino	crin	RAR, ZOO
kripla	inválido	
kripla	discapacitado	
kripla	minusválido	
kriplaĵo	minusvalía	MED
kriplaĵo	discapacidad	MED
kripligi	dejar inválido	
kripliĝi	quedarse inválido	
kriplulo	inválido	
kriplulo	discapacitado	
kriplulo	minusválido	
kripto	cripta	
kriptono	criptón	KEM
krisolo	crisol	KEM, TEK
kriterio	criterio	
kritika	crítico	KOMUNE
kritiki	criticar	KOMUNE
kritiko	crítica	KOMUNE
krizalido	crisálida	ZOO
kroketo	croquet	SPO
kromio	cromo	KEM
kromo	cromo	KEM
kromosomo	cromosoma	BIO
kromprocesoro	coprocesador	KOMP
kroni	coronar	FIG
kronika	crónico	MED
krono	corona	EKON, FIG
kronometro	cronómetro	
krotalo	crótalo	ZOO
kruc(ig)i	cruzar	
krucifikso	crucifijo	KRI
krucisto	cruzado	
krucmilitisto	cruzado	
kruco	cruz	FIG, KRI
krucumi	crucificar	
kruela	cruel	
krupiero	crupier	SPO
kruro	pierna	ANA
kruro	pata	ANA
kruzado	cruzado	EKON
kruĉo	jarra	
ksenono	xenón	KEM
kubuto	codo	ANA
kudri	coser	TEKS
kudrilo	aguja	TEKS
kufo	cofia	TEKS
kuglo	bala	
kuirejo	cocina	KUI
kuiri	cocinar	KUI
kuiristo	cocinero	KUI
kukejo	pastelería	
kuko	pastel	KUI
kukurbacoj	cucurbitáceas	BOT
kulero	cuchara	KUI
kulinara	culinario	KUI
kulmino	culminación	AST
kulombo	culombio	ELE
kumino	cumino	BOT, KUI
kumuluso	cúmulo	MET
kunaŭtoro	coautor	
kuniklo	conejo	ZOO
kunlabori	colaborar	
kunordigi	coordinar	GRA
kunordigilo	conjunción coordinativa	GRA
kunsenco	connotación	LIN
kunuzi	compartir	
kupeo	compartimento	FER
kupolo	cúpula	ARKI
kupra	de cobre	
kupro	cobre	BIB, KEM
kurento	corriente	ELE
kuriero	correo	POSX
kuriero	alfil	POSX
kuriumo	curio	KEM
kursano	cursillista	PED
kursivo	cursiva	TIP
kursivo	itálica	TIP
kurso	curso	EVI, KOMP, PED
kuseno	cojín	
kusentego	funda de cojín	
kusentego	funda de almohada	
kusentegilo	funda de cojín	
kusentegilo	funda de almohada	
kusensako	funda de cojín	
kusensako	funda de almohada	
kutro	cúter	MAR
kuvo	cubo	
kuŝi	yacer	
kuŝigi	tumbar	
kuŝigi	acostar	
kuŝiĝi	tumbarse	
kuŝiĝi	acostarse	
kvadrigo	cuadriga	HIS, SPO
kvadriko	cuadrática	MAT
kvakero	cuáquero	KRI
kvar	cuatro	
kvara	cuarto	
kvarangula	cuadrangular	
kvarko	quark	FIZ
kvaronjara	trimestre	
kvarono	un cuarto	
kvartalo	barrio	
kvazaro	quásar	AST
kvazaŭvokalo	semivocal	FON
duonvokalo	semivocal	FON
kverelema	pendenciero	
kverelema	peleón	
kverelema	camorrista	
kvereli	pelearse	
kvereli	disputar	
kvereli	reñir	
kverelo	riña	
kverelo	pelea	
kverelo	disputa	
kverko	roble	BOT
kvin	cinco	
kvintesenco	quintaesencia	
kvinteto	quinteto	MUZ
kvitanco	recibo	EKON
kvorumo	quórum	
la	el	
la	la	
la	lo	
la	los	
la	las	
labialo	labial	FON
labirinto	laberinto	
laborabelo	obrera	ZOO
laboratorio	laboratorio	
laborema	trabajador	
labori	trabajar	EKON
laboristo	trabajador	EKON
laborulo	trabajador	EKON
labormerkato	mercado de trabajo	EKON
laboro	trabajo	FIZ
laca	cansado	FIG
lado	lámina	TEK
ladskatolo	lata	
lafo	lava	GEOL, MIN
lago	lago	GEOG
laguno	laguna	GEOG
lakmus(a paper)o	papel de tornasol	KEM, MED
lakmuso	tornasol	KEM
lakrimalo	hueso lagrimal	ANA
lakso	diarrea	
lakto	leche	
laktozo	lactosa	KEM
laktuko	lechuga	BOT
lama	cojo	FIG
lamao	lama	BUD
lambastono	muleta	
lambdacizo	lambdacismo	FON, MED
lamelibrankoj	lamelibranquios	ZOO
lamenti	lamentar	
lami	cojear	
lamo	llama	ZOO
lamulo	cojo	
lanco	lanza	
landgrafo	condado	HIS
lando	país	GEOG, POL
lango	lengua	ANA, FIG
lano	lana	TEKS
lantano	lantano	KEM
lapiso	nitrato de plata	MIN
laplaca	de Laplace	
laringa frikativo	fricativa laringal	FON
laringito	laringitis	MED
laringo	laringe	ANA
larmo	lágrima	
larvo	larva	ZOO
larĝa	ancho	FIG
larĝo	anchura	
lasero	láser	FIZ, TEK
lasi	dejar	
lasi	abandonar	
lasta	último	
laste sed ne balaste	por último pero no menos importante	FRAZ
latenta	latente	MED
latitudo	latitud	AST, GEOG, MAT
latrono	ladrón	POE
latuno	latón	KEM
lavango	alud	
lavi	lavar	
lavurso	mapache	ZOO
lavurseto	mapache	ZOO
laĉi	enlazar	
laĉo	lazo	TEKS
laĉo	cordón	TEKS
laŭbo	pérgola	HOR
laŭcela	conforme	
laŭcela	adecuado	
laŭdano	láudano	KEM, MED
laŭdi	alabar	
laŭdi	laurear	
laŭdinda	alabable	
laŭdinda	laureable	
laŭleĝa	legal	JUR
laŭliniigi	alinear	
laŭmezura	a la medida	
laŭpeze	a peso	
laŭrencio	laurencio	KEM
laŭta	alto	
laŭtparolilo	altavoz	
leciono	lección	EVI
lecitino	lecitina	KEM, MED
ledo	cuero	
legendo	leyenda	BELE
legi	leer	FIG, KOMP
legio	legión	FIG, HIS, MIL
legomo	legumbre	KUI
leki	lamer	FIG
leksiko	léxico	LIN, RAR
leksikografio	lexicografía	LIN
leksikologio	lexicología	
lemo	lema	MAT
lempiro	lempira	EKON
lenso	lente	
lentugo	peca	
leono	león	ZOO
leopardo	leopardo	ZOO
lepidopteroj	lepidópteros	ZOO
leporo	liebre	ZOO
lepro	lepra	
leptono	leptón	FIZ
lerni	aprender	PED
lerta	hábil	
lerta	diestro	
lerta	amañado	
lesivo	lejía	
letargio	letargo	FIG
letero	carta	POSX
levi	elevar	FIG
levi	levantar	FIG
levi	elevar	FIG
levido	levita	
leviĝi	elevarse	FIG
levpordo	puente levadizo	ARKI
levrelo	perro lebrel	ZOO
leĝa	legal	
leĝaro	legislación	JUR
leĝigi	legalizar	
leĝo	ley	JUR, KOMUNE, SCI
leŭgo	legua	
leŭkemio	leucemia	MED
leŭkocito	leucocito	ANA, MED
li	él	
liano	liana	
libelo	libélula	ZOO
libera	libre	MAT
liberala	liberal	
libere	libremente	
libereco	libertad	
liberigi	liberar	
libero	libertad	
libido	libido	PSI
librejo	librería	ARK
libro	libro	TIP
librotenado	contabilidad	EKON
librotenejo	biblioteca	EKON, TIP
librotenisto	contable	EKON
librovendejo	librería	
licencio	licenciatura	PED
licenciulo	licenciado	PED
lici	estar permitido, -a	RAR
lici	ser lícito, -a	RAR
lieno	bazo	
lifto	ascensor	
lifto	elevador	
lignaĵisto	carpintero	
lignito	lignito	MIN
ligno	madera	
ligno	leño	
likva	líquido	FIZ
likvaĵo	líquido	FIZ
likvidi	liquidar	EKON
likvido	liquidación	ARK, EKON, FON
likvido	líquida	ARK, EKON, FON
likvigi	licuar	
likvoro	licor	KUI
liliputa	liliputiense	
limigi	limitar	FIG
limo	límite	ARK, FIG, MAT
limonado	limonada	KUI
lineare nedependa	linealmente independiente	MAT
lingva	lingüístico	
lingvano	hablante	LIN
lingvistika	lingüístico	
lingvistiko	lingüística	LIN, SCI
lingvisto	lingüista	
lingvosciencisto	lingüista	
lingvo	lengua	KOMP, LIN, MAT
lingvo	idioma	KOMP, LIN, MAT
lingvoscienco	lingüística	LIN, SCI
liniaro	pentagrama	MUZ
linie	linealmente	
linio	línea	BELA, MAT, TRA
linko	lince	ZOO
lino	lino	BOT
linoleo	aceite de lino	
linotipisto	linotipista	
linotipo	linotipia	TEK, TIP
linotipo	linotipo	TEK, TIP
linĉi	linchar	JUR
lipharoj	bigote	
lipo	labio	ANA, FIG
lirika	lírico	
lirikeco	liricidad	
liriko	lírica	POE
liro	lira	EKON, MUZ
liro	lira	EKON, MUZ
listo	lista	KOMP
litanio	letanía	FIG, KAT
litargiro	litargirio	KEM
literaturo	literatura	
litero	letra	FIG
literumi	deletrear	
litino	litina	KEM, MED
litio	litio	KEM
lito	cama	
litografi	litografiar	
litografio	litografía	TIP
litografisto	litógrafo	
litoto	lítote	BELE, LIN
litro	litro	
littuko	sábana	TEKS
litotuko	sábana	TEKS
liturgio	liturgia	KAT, KRI
liva	izquierdo	RAR
liveri	entregar	EKON
lobelio	lobelia	BOT
lobo	lóbulo	
lofi	orzar	MAR
logaritma dekremento	decremento logarítmico	FIZ
logaritmo	logaritmo	MAT
logi	atraer	
logi	tentar	
logiko	lógica	FIL
logo	atractivo	
logaĵo	atractivo	
logilo	atractivo	
logogrifo	logogrifo	FIG
lojala	leal	
lojaleco	lealtad	
lokalizi	localizar	
lokalo	local	
loko	lugar	FIG, KOMP, MAT
lokomobilo	locomóvil	
lokomotivo	locomotora	FER
lokusto	langosta	ZOO
longa	largo	FON, POE
longa fingro	dedo medio	ANA
longitudo	longitud	AST, GEOG, MAT
longo	longitud	FIZ
longoforma	alargado	
lordo	lord	
lotado	sorteo	
loterio	lotería	FIG, SPO
lotumi	sortear	
lozanĝo	rombo	HER, MAT
loĝanto	habitante	
loĝebla	habitable	
loĝi	habitar	
loĝi	vivir	
loĝi	residir	
loĝi	morar	
loĝigi	acoger	
loĝigi	hospedar	
lubrikaĵo	lubricante	
lubriki	lubricar	TEK
lubriko	lubricación	
lubriko	lubrificación	
lucerno	lucerna	
ludi	jugar	MUZ, SPO, TEA
ludi	jugar	MUZ, SPO, TEA
ludi	apostar	MUZ, SPO, TEA
ludi	tocar	MUZ, SPO, TEA
ludi	actuar	MUZ, SPO, TEA
ludo	juego	
lui	alquilar	EKON
lui	arrendar	EKON
luigi	alquilar	EKON
luigi	arrendar	EKON
luko	claraboya	ARKI, MAR
luko	lucera	ARKI, MAR
luko	lucernario	ARKI, MAR
luksa	lujoso	
lukso	lujo	
lukti	luchar	SPO
luli	mecer	FIG
luli	calmar	FIG
luli	arrullar	FIG
luli	adormecer	FIG
luli	sosegar	FIG
lulilo	cuna	FIG
lulkanto	nana	
lulseĝo	mecedora	
lumbaĵo	lomo	KUI
lumbo	zona lumbar	ANA
lumbo	lomo	ANA
lumdisko	disco compacto	KOMP, MUZ
lumi	brillar	FIG
lumigi	iluminar	FIG
lumigi	alumbrar	FIG
lumilo	lumbrera	
lumjaro	año luz	AST
lumo	luz	FIG, FIZ
lumo	luz	FIG, FIZ
lumo	lumbrera	FIG, FIZ
lumo	lumbrera	FIG, FIZ
lumturo	faro	ARKI, FIG
luna	lunar	
lundo	lunes	KAL
lunkalendaro	calendario lunar	KAL
luna kalendaro	calendario lunar	KAL
luno	Luna	AST
luno	luna	AST
lunĉo	merienda	
lupeo	lupa	FOT
lupido	lobatos	SPO, ZOO
lupido	alita	SPO, ZOO
lupido	lobata	SPO, ZOO
lupo	lobo	ZOO
lupolo	lúpulo	BOT
lupuso	lupus	MED
lustro	lucerna	
lustro	araña	
lutecio	lutecio	KEM
luter(an)ismo	luteranismo	KRI
luterano	luterano	KRI
luti	soldar	
luti	estañar	
maceri	macerar	KEM, KUI, MED
madrigalo	madrigal	POE
magazino	revista	
magia	mágico	FIG
magio	magia	
magmo	magma	GEOL, MAT
magnetismo	magnetismo	
magnetito	magnetita	MIN
magneto	imán	
magnetofono	grabadora	
magnetofono	magnetófono	
magnezio	magnesio	FOT, KEM, MED
mahometano	mahometano	EVI, REL
maizo	maiz	AGR, BOT
maizpano	tortilla	KUI
majoliko	mayólica	
majonezo	mayonesa	KUI
majordomo	mayordomo	
majstro	maestro	
majuskla	mayúscula	HIS, KOMP, TIP
majuskla	en mayúsculas	HIS, KOMP, TIP
majusklo	letra mayúscula	GRA, KOMP, TIP
makaronio	macarrones	KUI
makrocefaledoj	cachalote	ZOO
maksimo	máxima	BELE
makuli	manchar	
makuli	ensuciar	
makulo	mancha	FIG
malaboni	desabonarse de	KOMP
malaboni	desuscribirse de	KOMP
malafabla	rudo	
malagrabla	desagradable	
malakito	malaquita	MIN
malaltmaro	marea baja	MAR
malamiko	enemigo	MIL
malamo	odio	
malario	malaria	MED
malavara	generoso	
malbeni	maldecir	FIG, REL
malbonigi	empeorar	
malbonodori	apestar	
odoraĉi	apestar	
malbuton(um)i	desabotonar	
maldekstrulo	zurdo	POL
maldekstrulo	izquierdista	POL
maldekstruma	levógiro	MAT, SCI
maldekstruma	antihorario	MAT, SCI
maldetala	burdo	EKON
maldetale	burdamente	EKON
maldika	delgado	
maldiskreta	indiscreto	MAT
maldiskreta	continuo	MAT
maldormi	estar despierto	
maleo	mazo	
maleolo	tobillo	ANA
malestimi	desestimar	
malfacila	difícil	
malfacilaĵo	dificultad	
malfermi	abrir	FIG
malfermita	(sílaba) libre	FON, MAT
malfidi	desconfiar	
malforta	débil	
malfortaĵo	debilidad	
malfortigi	debilitar	
malfortiĝi	debilitarse	
malgaja	triste	
malgaji	estar triste	
malgajni	perder	EKON
malglata	áspero, -a	
malglata	difícil	
malglata	carrasposo, -a	
malgracia	torpe	
malgracia	feo	
malgranda	pequeño	
malgranda duonakso	semi eje menor	MAT
malgranda fingro	meñique	ANA
malgrandegulo	enano	
malhavi	indispensable	
malhavi	carecer de	
malhelpo	impedimento	
malhelpo	obstáculo	
malhelpo	estorbo para algo	
malinfekti	desinfectar	MED
seninfektigi	desinfectar	MED
malinflacio	deflación	EKON
malinstali	desinstalar	
malinstalilo	programa de desinstalación	KOMP
malinstalilo	desinstalador	KOMP
malizotropa	anisotrópico	FIZ
maljesi	negar	RAR
maljuna	viejo	
malkaŝi	desocultar	
malkaŝi	descubrir	
malkaŝi	dar a conocer	
malkaŝi	sacar a la luz	
malkaŝi	revelar	
malkaŝi	sacar	
malkaŝo	desocultamiento	
malkaŝo	descubrimiento	
malkaŝo	revelación	
malklara	oscuro	
malkombi	despeinar	
malkonekti	desconectar	ELE, KOMP, TEK
malkonekti	desenchufar	ELE, KOMP, TEK
malkonverĝi	divergir	MAT
malkorekta	erroneo	
malkorekta	equivocado	
malkovri	descubrir	
mallakso	constipado	
mallakso	estreñimiento	
mallarĝa	angosto	
mallarĝa	estrecho	
mallaŭdi	desalabar	
mallaŭdi	vituperar	
mallaŭdinda	desalabable	
mallaŭdinda	vituperable	
mallaŭta	bajo	
mallaŭta	silencioso	
malliberejo	cárcel	
malliberejo	prisión	
mallogi	desagradar	
mallojala	desleal	
mallonga	corto	FON, POE
mallongigi	acortar	
mallongigi	abreviar	
mallongigo	abreviatura	GRA
malluma	oscuro	
malluma	obscuro	
mallumo	oscuridad	FIG
mallumo	obscuridad	FIG
malmodera	desmesurado	
malmodera	excesivo	
malneto	borrador	
malnova	viejo	EVI
malobservi	transgredir	
malobservi	violar	
malofta	infrecuente	
malofta	que ocurre poco	
malofta	raro, -a	
maloftaĵo	rareza	
malofte	infrecuentemente	
malofte	raramente	
malpeza	ligero	
malpezigi	aligerar	
malplekti	destrenzar	
displekti	destrenzar	
malplena	vacio	
malplenumi	incumplir	
malpli	menos	
malpura	sucio	
malpurigi	ensuciar	
malpuriĝi	ensuciarse	
malriĉa	pobre	EKON
malriĉigi	empobrecer	
malriĉiĝi	empobrecerse	
malriĉo	pobreza	
malriĉulo	pobre	
malsama	distinto	
malsata	hambriento	KUI
malsati	tener hambre	
malsati	estar hambriento	
malseka	mojado	
malseketa	húmedo	
malsimpatii	rechazar	
malsimpatio	antipatía	
malto	malta	
malvarma	frío	FIG
malvarmeta	fresco	
malvarmeto	frescura	
malvarmo	frío	FIG
malvarmumi	costiparse	MED
malvarmumi	resfriarse	MED
malvarmumi	acatarrarse	MED
malvarmumi	enfriarse	MED
malvesti	desvestir	
malĉastejo	burdel	
malĉifri	descifrar	KOMP, MIL
malĝentila	grosero	
malĝentilulo	grosero	
malĝoja	triste	
malĝoji	estar triste	
malĝojo	tristeza	
malŝati	despreciar	
manao	maná	BIB
manartiko	muñeca	ANA
mandareno	mandarín	
mandarino	mandarina	BOT, KUI
mandato	mandato	
mandolino	mandolina	MUZ
mandorso	dorso	ANA
mangano	manganeso	KEM
manifestacio	manifestación	
maniko	manga	TEKS
manio	manía	KOMUNE, PSI
manlaboro	trabajo manual	
mano	mano	ANA
manovri	maniobrar	FIG
manplato	palma	ANA
manpleno	puño	FIG
manradiko	muñeca	ANA
mansako	bolsa de mano	TEKS
mansupro	dorso	ANA
mantro	mantra	BUD
manumo	puño	TEKS
manuskripto	manuscrito	TIP
manuzi	manipular	
manĝaĵo	comida	
manĝi	comer	FIG
manĝigi	dar de comer	
manĝilo	cubierto	KUI
manĝokarto	menú	KUI
maparo	atlas	GEOG
mapo	mapa	AST, GEOG
maravedo	maravedí	EKON
mardo	martes	KAL
marerinaco	erizo de mar	KOMUNE, ZOO
margarino	margarina	KUI
markaŝtano	erizo de mar	KOMUNE, ZOO
markezo	toldo	ARKI
marmelado	mermelada	KUI
marmelado	jalea	KUI
maro	mar	EVI, FIG, GEOG
marsa	marciano	AST, MIT
marsano	marciano	
marseljezo	Marsellesa	
marstelo	estrella de mar	KOMUNE, ZOO
martirigi	martirizar	
martiro	mártir	FIG, REL
marto	marzo	KAL
marĝeno	margen	
marŝalo	Mariscal	MIL
marŝi	marchar	MIL
marŝi	caminar	MIL
marŝo	marcha	MUZ
masaĝi	dar masaje	
masaĝi	dar un masaje	
masaĝi	masajear	
masaĝo	masaje	
masto	palo	MAR
masto	mástil	MAR
masto	mastelero	MAR
mastodonto	mastodonte	PAL, ZOO
mastri	amo	
mastri	capataz	
matenmanĝo	desayuno	KUI
materia	material	
materiismo	materialismo	FIL
materio	materia	FIL
matraco	colchón	
mazurko	mazurca	MUZ
maĉi	masticar	
maĉo	partido	SPO
maĥinacio	maquinación	RAR
maŭra	moro	
maŭro	moro	HIS
maŭzoleo	mausoleo	ARKI
medikamento	medicamento	MED
medio	medio	EKOL, KEM, POL
mediti	meditar	
mediumo	médium	
meduzo	medusa	ZOO
megafono	megáfono	TEK
megalomanio	megalomanía	PSI
megaomo	megaohmio	ELE
mejlo	milla	
mekaniko	mecánica	
meleagro	pavo	ZOO
meleagro	chompipe	ZOO
melinito	melinita	KEM, MIL
melodramo	melodrama	
melono	melón	BOT, KUI
membiografio	autobiografía	BELE
memestimo	autoestima	PSI
memfido	fe en sí mismo	
memkritiko	autocrítica	
mendelevio	mendelevio	KEM
menhiro	menhir	ARKE
meningito	meningitis	MED
meningo	meninge	ANA
mensa	mental	
menso	mente	
mensogema	mentiroso, -a	
mensogi	mentir	FIG
mensogo	mentira	
mensogulo	mentiroso, -a	
menstruo	menstruación	MED
menstruo	regla	MED
menstruo	período	MED
mentoro	mentor	PED
menuo	menú	KOMP, KUI
meridiano	meridiano	GEOG, MAT
meridiano	meridiano	GEOG, MAT
merita	meritorio	
merita	merecido	
meritaĵo	recompensa	
meriti	merecerse	
meriti	merecer	
meriti	tener méritos de	
meriti	hacer méritos para	
merito	mérito(s)	
merkantilismo	mercantilismo	EKON, JUR
merkato	mercado	EKON
merkredo	miércoles	KAL
merlango	merlán	ZOO
merlango	plegonero	ZOO
merlo	mirlo	ZOO
mesio	Mesias	FIG, REL
mesio	mesías	FIG, REL
meso	misa	KAT
mestizo	mestizo	
metabolo	metabolismo	BIO
metafiziko	metafísica	
metalo	metal	KEM
metaloido	metaloide	KEM
metaloido	semimetal	KEM
metalurgio	metalurgia	
metamorfa	metamórfico	MIN
metatarso	metatarso	ANA
metatezo	metátesis	FON
metonimio	metonimia	LIN
metopo	metopa	ARKI
metopo	métopa	ARKI
metronomo	metrónomo	MUZ
meza	medio	
meze de	en medio de	
meze en	en medio de	
meze inter	en medio de	
en la mezo de	en medio de	
mezepoko	edad media	HIS
mezono	mesón	FIZ
mezurado	medición	
mezurateco	mesura	ARK
mezuri	medir	FIG
mezuro	medida	FIG, MAT, MUZ, POE
meĥanismo	mecanismo	FIG, FIL
meĥanismo	mecanismo	FIG, FIL
mi	yo	
mi	mi	
miaŭi	maullar	
miaŭo	maullido	
miela	de miel	FIG
miela	meloso	FIG
mielo	miel	
mielĉelaro	panal	
mieno	gesto	
mikado	micado	
mikozo	micosis	MED
mikrobiologio	microbiología	BAK, SCI
mikrobo	microbio	BAK
mikrofarado	microfaradio	ELE
mikrometro	micrómetro	
mikroskopa	microscópico	
mikroskopo	microscopio	FOT
mil	mil	
milicio	milicia	
milico	milicia	
miligramo	miligramo	
milimetro	milímetro	
miliono	millón	
milionulo	millonario	
militaviadilaro	aviación	AVI, MIL
milita aviadilaro	aviación	AVI, MIL
militaviadilo	avión militar	AVI, MIL
milita aviadilo	avión militar	AVI, MIL
mimiko	mímica	
minaci	amenazar	FIG
minaco	amenaza	FIG
minejo	mina	
mineralo	mineral	MIN
mineralogio	mineralogía	MIN, SCI
ministerio	ministerio	
ministro	ministro	POL
ministro	secretario	POL
minus	menos	FIZ, MAT
minuskla	minúsculo	HIS, KOMP, TIP
minuskligi	pasar a minúsculas	KOMP, TIP
minusklo	minúscula (letra)	GRA, KOMP, TIP
minuso	signo menos	FIG, KOMP, MAT, TIP
minuso	carencia	FIG, KOMP, MAT, TIP
miraklo	milagro	FIG
miraĝo	espejismo	FIG, FOT
miri	maravillarse	
mirmeleono	hormiga león	ZOO
miro	maravilla	
misagorda	desafinado	MUZ
miskompreni	malinterpretar	
mistralo	mistral	MET
mitingo	mitin	
mito	mito	FIG, MIT
mitologio	mitología	MIT, SCI
mjelo	médula espinal	ANA
mnemotekniko	mnemotécnica	
modera	moderado, -a	
modereco	moderación	
modero	moderación	
moderigi	moderar	
moderna	moderno	
modesta	modesto, -a	
modifi	modificar	
modistino	modista	TEKS
modkanto	éxito	MUZ
modkanto	hit	MUZ
modo	moda	GRA, TEKS
modo	modo	GRA, TEKS
modo	modo	GRA, TEKS
modulacio	modulación	
mokaseno	mocasín	TEKS
mola	suave	FON
molibdeno	molibdeno	KEM
molibdeno	molibdénio	KEM
momenta	momentáneo	FON
momento	momento	
mona	monetario	EKON
monarĥo	mobarca	JUR, POL
monato	mes	AST
monaĥejo	monasterio	REL
monaĥinejestrino	madre superiora	REL
monaĥinejo	convento	REL
monaĥino	monja	REL
monaĥo	monje	REL
mondcivitano	ciudadano del mundo	
mondo	mundo	
monfalsisto	falsificador	EKON
mongola	mongol	
mongolo	mongol	
mono	dinero	EKON
monoido	monoide	MAT
monolito	monolito	ARKI
monomo	monomio	MAT
monoplano	monoplano	AVI
monoteismo	monoteísmo	
monoteisto	monoteísta	REL
monpuno	multa	JUR
montaro	cordillera	GEOG
monteto	colina	GEOG
monto	del dicho al hecho, hay mucho trecho	FIG, FRAZ, GEOG
monto	montaña	FIG, FRAZ, GEOG
montrofingro	dedo índice	ANA
monujo	monedero	
mordento	mordente	MUZ
morfologio	morfología	GRA
moro	costumbre	
moro	modo de vida	
mortero	mortero	
moruo	bacalao	ZOO
mosto	mosto	
moto	lema	BELE
motorciklo	motocicleta	
movimento	movimiento	MUZ
muelejo	molino	AGR
mueli	moler	FIG
mueli	moler	FIG
muelilo	molino	
muelŝtono	piedra de molino	AGR
muftio	muftí	ISL
mugilo	mujol	ZOO
mugilo	lisa	ZOO
mugilo	galupe	ZOO
mukozo	mucosa	ANA
mukozo	membrana mucosa	ANA
mulato	mulato	
mulo	mulo, mula	
multenombro	plural	GRA
multiplikendo	multiplicando	ARK, MAT
multnombra	numeroso	
multenombra	numeroso	
multvalora	valioso	
multevalora	valioso	
municio	munición	MIL
muono	muón	FIZ
musono	monzón	MET
muzeo	museo	ARKI
muzikinstrumento	instrumento musical	MUZ
muziko	música	MUZ
muŝbirdo	colibrí	ZOO
muŝo	mosca	KOMUNE, ZOO
nacia	nacional	EVI
nacianigi	nacionalizar	JUR, POL
nacieco	nacionalidad	POL
naciismo	nacionalismo	LIN, POL
nacio	nación	EVI, HIS, JUR, POL
nacionalismo	nacionalismo	ARK
nadlo	aguja	TEK
naftalino	naftalina	KEM
najado	náyade	
najbaro	vecino	
najli	clavar	
najlo	clavo	
nano	enano	
napalmo	napalm	KEM, MIL
narciso	narciso	BOT
naski	parir	FIG, MAT
naski	dar a luz	FIG, MAT
naskiĝi	nacer	FIG
natrio	sodio	KEM
natura	natural	MUZ
naturalismo	naturalismo	BELE, ESP, FIL
naturo	naturaleza	KRI
navo	nave	ARKI
nazalo	nasal	FON
nazia	nazi	
nazia	nacionalsocialista	
naziismo	nazismo	POL
naziismo	nacionalsocialismo	POL
nazio	nazi	POL
nazo	nariz	ANA, FIG, ZOO
naztuko	pañuelo	TEKS
naĝilo	aleta	ZOO
naŭ	nueve	
naŭzi	producir náuseas	FIG
naŭzi	nausear	FIG
naŭzo	náuseas	
ne	no	
nea	negativo	GRA
neatendite	inesperadamente	
nebula	nublado	FIG
nebula	neblinoso	FIG
nebula	nebuloso	FIG
nebula	nebuloso	FIG
nebulastro	nebulosa	AST
nebulo	niebla	FIG, MET
nebulo	neblina	FIG, MET
nebulo	niebla	FIG, MET
nebulo	niebla	FIG, MET
neces(ec)o	necesidad	
necesa	necesario	FIL
neegalaĵo	desigualdad	MAT
neesto	inexistencia	
nefleksiebla	invariable	GRA
senfleksia	invariable	GRA
neforgesebla	inolvidable	
neg(ad)o	negación	
nega	negativo	
negacio	negación	GRA, MAT
negi	negar	
negoco	negocio	EKON
nei	negar	
neimagebla	inimaginable	
nek	ni	
nek ... nek ...	ni	
nekrologo	necrológica	
nekropolo	catacumbas	
nekropsio	autopsia	ANA
nekropsio	necropsia	ANA
nektaro	néctar	BOT, FIG, MIT
nelacigebla	incansable	
nelonge	con brevedad	
nelonge	brevemente	
neniam	nunca	
nenie	en ningún sitio	
nenie	en ninguna parte	
nenie	en ningún lugar	
nenies	de nadie	
nenio	nada	
neniu	nadie	
neodimo	neodimio	KEM
neolitiko	neolítico	PRA
neono	neón	KEM
neparhufuloj	perisodáctilos	ZOO
nepo	nieto	GEN
nepotismo	nepotismo	
nepra	inevitable	
nepra	insoslayable	
neprigi	hacer necesario algo	
neprigi	insoslayabilizar	
neprofitema	no lucrativo	
neptunio	neptunio	KEM
nereala	irreal	
malreala	irreal	
nerva	nervioso	
nervo	nervio	ANA
nervoza	nervioso	
neta	neto	
netipa pneŭmonio	neumonía atípica	MED
netransitiva	intransitivo	GRA, MAT
nevo	sobrino	GEN
neĝero	copo de nieve	MET
neĝo	nieve	MET
neŭralgio	neuralgia	MED
neŭrologo	neurólogo	SCI
neŭrozo	neurosis	MED, PSI
neŭtono	newton	FIZ
neŭtra	neutro	KEM, LIN, MAT
neŭtrala	neutral	
neŭtrino	neutrino	FIZ
neŭtrono	neutrón	FIZ
ni	nosotros	
nia	nuestro	
nifo	ovni	
nigra	negro	FIG
nigra truo	agujero negro	AST
nigrevidulo	pesimista	
nigrigi	ennegrecer	FIG
nigro	negro	
nihilismo	nihilismo	
nihilisto	nihilista	
nikeli	niqueler	
nikelo	níquel	KEM
nikotino	nicotina	
nimbuso	nimbo	MET
niobo	niobio	KEM
niti	remachar	TEK
nitnajlo	roblón	TEK
nito	remache	TEK
nitrata acido	ácido nítrico	KEM
nitroglicerino	nitroglicerina	KEM, MIL
niĉo	nicho	ARKI, EKON
nobela	noble	
nobela	aristocrático, -a	
nobelaro	la nobleza	
nobelaro	los nobles	
nobelaro	la aristocracia	
nobeleco	nobleza	
nobeleco	aristocracia	
nobelio	nobelio	KEM
nobelo	noble	POL
nobelo	aristócrata	POL
noci	dañar	RAR
noci	perjudicar	RAR
nokti	ser de noche	EVI
noktiĝi	anochecer	
nokto	noche	FIG, KAL
noktomezo	medianoche	KAL
nokturno	nocturno	MUZ
nomada	nómada	
nomadismo	nomadismo	
nomado	nómada	
nombronomo	numeral	GRA
nombrosistemo	sistema numérica	KOMP, MAT
nomenklaturo	nomenclatura	SCI
nomi	llamar	
nominativo	nominativo	GRA
nomiĝi	llamarse	
nomo	nombre	GEN, LIN
nomo	nombre	GEN, LIN
nordo	norte	GEOG
norio	noria	AGR
normala	normal	EVI, MAT
nova	nuevo	
novembro	noviembre	KAL
novicino	novicia	REL
novico	principiante	EVI, REL
novico	novicio	EVI, REL
novriĉulo	nuevo rico	
novulo	principiante	
nuba	nublado, -a	FIG, MET
nubo	nube	FIG, MET
nudelo	pasta	KUI
nukleo	nícleo	BIO, FIZ
nuko	nuca	ANA
nukso	nuez	BOT, KOMUNE
nula	nulo	MAT
nuligi	anular	MAT
nulo	cero	FIG, MAT
numeralo	numeral	GRA, KOMP
numeratoro	numerador	MAT
numerebla	numerable	MAT
numeri	numerar	
numero	número	
numero	ejemplar	
nun	ahora	
nuna	actual	
nuntempo	presente	GRA
nupto	nupcias	POE
nur	sólo	
nur	solamente	
nura	único	
o-vorto	sustantivo	GRA
o-vorto	nombre	GRA
oazo	oasis	FIG, GEOG
obei	obedecer	
obelisko	obelisco	ARKI
obio	obi	TEKS
objektiva	objetivo	
objektiveco	objetividad	
objekto	objeto	FIL, GRA
obsedi	obsesionar	
obsedo	obsesión	
observado	observación	
observanto	observador	POL
observaĵo	observación	
observi	observar	
observulo	observador (sust.)	
obstaklo	obstáculo	
obstrukci	obstruir	POL
obstrukco	obstrucción	POL
obtuza	obtuso	FON, MAT, MUZ
oceano	océano	GEOG
odora	oloroso	
odori	oler	FIG
odoro	olor	
ofenda	ofensivo	
ofendi	ofender	
ofendiĝi	ofenderse	
ofendiĝo	ofensa	
ofendo	ofensa	
oferti	ofrecer	EKON
oficiala	oficial	POL
oficialigi	oficializar	
ofico	oficio	
ofta	frecuente	
oftalmologio	oftalmología	SCI
ofte	frecuentemente	
ofte	a menudo	
ofte	muchas veces	
ofteco	frecuencia	
ok	ocho	
okapio	okapi	ZOO
okcidento	oeste	GEOG
okcidento	occidente	GEOG
oksid(ig)i	oxidar	KEM
oksido	óxico	KEM
oksigeni	oxigenar	
oksigeno	oxígeno	KEM
oktanto	octante	AST, MAT
okula	ocular	
okulglobo	globo ocular	ANA
okulharoj	cejas	
okulisto	oculista	
okullenso	cristalino	ANA
okulo	ojo	ANA, FIG
okulvitroj	gafas	FOT
okulvitroj	lentes	FOT
okupi	ocupar	
olapodrido	olla podrida	KUI
olei	aceitar	
oleo	aceite	BOT
oligarkio	oligarquía	POL
oligopolo	oligopolio	EKON
oligopsonio	oligopsonio	EKON
omleto	tortilla	KUI
omleto	omelet	KUI
onda	ondular	
onda	ondulado, -a	
onda lado	lámina corrugada	TEK
ondi	ondular	
ondi	fluctuar	
ondi	dispersarse	
ondiĝo	ondulación	
ondiĝo	fluctuación	
ondo	ola	
ondo	onda	
ondo	oleada	
ondumi	ondular	
onomatopeeaĵo	onomatopeya	
opinienketo	encuesta de opinión	POL
oponanto	opositor	
oponi	oponer	
optativo	optativo	GRA
optika fibro	fibra óptica	TEK, TEL
oranĝo	naranja	KUI
oratorio	oratorio	MUZ
orbito	órbita	ANA, AST, FIG, RAR
ordigi	ordenar	KOMP
ordinara	ordinario	
ordinato	ordenada	MAT
ordo	orden	BOT, MAT, ZOO
ordo	orden	BOT, MAT, ZOO
ordona	ordenado, -a	
ordona	mandado, -a	
ordona	mandatorio, -a	
ordonema	mandón, mandona	
ordoni	ordenar	
ordoni	mandar	
ordono	orden	KOMP
ordono	mandato	KOMP
ordono	comando	KOMP
ordono	instrucción	KOMP
orelo	oreja	ANA, FIG
orelringo	pendiente	
oreltamburo	tímpano	ANA
organiz(ad)o	organización	
organizaĵo	organización	
organizi	organizar	
organizo	organización	
organo	órgano	ANA, BIO, TEK
orgojla	arrogante	
orgojlo	arrogancia	
orienta	oriental	
orienti	orientar	MAT
oriento	este	BIB, GEOG
oriento	oriente	BIB, GEOG
origini	originar	
origino	origen	MAT
ornamaĵo	adorno	BELA
ornami	adornar	
oro	oro	EKON, KEM
ortocentro	ortocentro	MAT
ortodoksa	ortodoxo	KRI
ortodoksa kristanismo	cristianismo ortodoxo	
oscedi	bostezar	
oska	osco	
osko	osco	HIS
osmio	osmio	KEM
ostaĝo	rehén	
ovacii	ovacionar	
ovacio	ovación	
ovalo	óvalo	MAT
ovoflav(aĵ)o	yema	
ovri	abrir	POE
paca	pacífico	FIG
pacienca	paciente	
pacienco	paciencia	
pacifismo	pacifismo	POL
pacifisto	pacifista	POL
pacigi	pacificar	
pacismo	pacifismo	
pacisto	pacifista	
paco	paz	
pado	sendero	TRA
pado	senda	TRA
pado	camino	TRA
paeljo	paella	KUI
pagajo	pagaya	SPO
pajlo	paja	AGR
pala	pálido	FIG
palaco	palacio	ARKI
paladio	paladio	KEM
palatalo	palatal	FON
paledo	palé	TRA
paleografio	paleografía	
paletro	paleta	BELA
paliĝi	palidecer	
palpe	a tientas	
palpebla	palpable	FIG
palpi	palpar	
pamfleto	panfleto	BELE
panei	averiarse	
panei	sufrir una avería	
paneo	avería	TEK
panerumi	empanizar	KUI
panumi	empanizar	KUI
paniko	pánico	
panisto	panadero	
pano	pan	FIG
panrostilo	tostador	KUI
pantero	pantera	ZOO
pantoflo	pantufla	TEKS
papilio	mariposa	ZOO
parabolo	parábola	BELE, MAT
paraboloido	paraboloide	MAT
paradizludo	coxcojilla	SPO
parafino	parafina	
parafo	rúbrica	
paragrafo	párrafo	
paragrafo	párrafo	
paralizi	paralizar	
paralizo	parálisis	
paranojo	paranoia	MED, PSI
paranojulo	paranoico	
paraziti	parasitar	
parazito	parásito	EKOL, FIG
paraŝuto	paracaídas	AVI, SPO
parco	parca	MIT
parentezo	paréntesis	GRA, TIP
parentezo	inciso	GRA, TIP
parentezo	paréntesis	GRA, TIP
parfumi	perfumar	
parfumo	perfume	
parhufuloj	artiodáctilos	ZOO
pario	paria	ANA, FIG, TEK
pario	paria	ANA, FIG, TEK
parkere	de memoria	
parodii	parodiar	BELA
parodio	parodia	BELA
paroli	hablar	FIG
parolo	habla	
parolo	palabra	
participo	participio	GRA
partiklo	partícula	FIZ
partikulo	partícula	GRA
pasaĝero	pasajero	TRA
pasaĝero	viajero	TRA
pasia	apasionado	
pasio	pasión amorosa	
pasio	pasión	
pasiva	pasivo	GRA
pasivo	pasiva	GRA
pasivo	pasivo	GRA
paskala	de Pascal	
paskalo	pascal	FIZ
pasporto	pasaporte	
pastelo	pastilla	MED
pasto	pasta	KUI
pasvorto	contraseña	
patelo	rótula	ANA, ZOO
pato	sartén	
patrino	madre	FIG, GEN
patro	padre	GEN, KRI
patrolo	patrulla	
pavano	pavana	MUZ
pavi	pavonear(se)	FIG
pavimero	adoquín	
pavimi	pavimentar	
pavimo	pavimento	
pavo	pavo real	FIG, ZOO
paĉulo	pachulí	
paŝi	carminar	
paŝi	dar pasos	
paŝi	andar	
paŝo	caminar	FIG, MAT
paŝo	paso	FIG, MAT
paŝtelo	pastel	
paŭsaĵo	calco	
paŭsi	calcar	
paŭso	calco	
pecigi	fragmentar	
peco	pedazo	
peco	pieza	
peco	fragmento	
pedagogia	didáctico	
pedalo	pedal	
pedanta	pedante	
pejzaĝisto	paisajista	BELA
pejzaĝo	paisaje	BELA
pelerino	pelerina	TEKS
peli	impeler	
peli	empujar	
peli	perseguir	
peli	instigar	
pendi	colgar	FIG
pendi	bezañ krouget	FIG
pendi	ser colgado	FIG
pendigi	colgar	BIB
pendigilo	horca	
pendingo	horca	EVI
pendumi	colgar	
pendumi	ahorcar	
pendumilo	horca	
peni	esforzarse en	
peni	empeñarse en	
peninda	que vale la pena	
penindi	valer la pena	
peniso	pene	ANA
peniso	miembro viril	ANA
peno	esfuerzo	
pensio	pensión	EKON
pentagono	pentágono	MAT
peono	peón	SPO
pepsino	pepsina	
percepti	percibir	
percepto	percepción	FIL
perei	perecer	
perfekta	perfecto	MAT
perfida	traicionero, -a	
perfidi	traicionar	
perfido	traición	
perfidulo	traidor	
perforti	forzar	
pergameno	pergamino	
pergolo	pérgola	ARKI, HOR
perifrazo	perífrasis	LIN
perigeo	perigeo	AST
perihelio	perihelio	AST
perikarpo	pericarpio	BOT
perimetro	perímetro	MAT
perineo	perineo	ANA
periosto	periostio	ANA
periskopo	periscopio	MIL, TEK
peristilo	peristilo	ARKI
peritoneo	peritoneo	ANA
perpendikulara	perpendicular	MAT
perpendikularo	perpendicular	MAT
perpleksa	perplejo, -a	
perplekso	perplejidad	
persekuti	perseguir	FIG, JUR
persona	personal	
persona komputilo	computadora personal	KOMP
personeco	personalidad	
persono	persona	GRA, KRI
perspektivo	perspectiva	BELA, FIG
peruko	peluca	
peseto	peseta	EKON
pesilo	balanza	
pesilo	báscula	
pesimisto	pesimista	
peso	peso	EKON
petromizo	lamprea	ZOO
petromizo	morena	ZOO
peza	pesado	FIG
pezi	pesar	
pezilo	peso	
pezo	peso	
piano	piano	MUZ
pico	pizza	KUI
pigra	haragán	RAR
pigra	haragana	RAR
pigra	perezoso	RAR
pigra	perezosa	RAR
pigra	vago	RAR
pigro	holgazanería	RAR
pigro	pereza	RAR
pikniki	ir de excursión	
pikniki	ir de picnic	
pikniki	hacer un picnic	
pilgrimi	peregrinar	
pilko	balón	MED, SPO, TEK
pilolo	píldora	MED
pinaklo	pináculo	ARKI
pindo	pinta	
pinglo	alfiler	BOT
pingveno	pingüino	ZOO
pingvino	pingüino	EVI, ZOO
pino	pino	BOT
pinta	puntiagudo, -a	
pinta	puntudo, -a	
pintigi	sacarle punta	
pinto	punta	
pinto	puya	
pinto	punta	
pinto	exstremo	
pinĉi	pellizcar	
pinĉi	pinzar	
pinĉilo	pinza	ZOO
pinĉpreno	Pellizco	
pipo	pipa	
pipro	pimienta	KUI
piramido	pirámide	ARKI, FIG, MAT
piroteknikaĵo	fuegos artificiales	
pirotekniko	pirotecnia	
pirozo	pirosis	MED
pisi	mear	FIZL, KOMUNE
pisi	hacer pipi	FIZL, KOMUNE
pispoto	orinal	KOMUNE
pistako	pistacho	
piĉo	coño	ANA
piĝino	pidgin	LIN
piĵamo	pijama	TEKS
piŝto	pistón	TEK
placo	plaza	ARKI
plado	plato	KUI
plafono	techo	ARKI
planedo	planeta	AST
plani	planear	
plano	plan	
plasmo	plasma	ANA, FIZ
plastika	plástico, -a	
plastiko	Plástica	
plastiko	Artes Plásticas	
plasto	plástico	TEK
platano	plátano	BOT
plateno	platino	KEM
platformo	plataforma	FER
platglobo	planisferio	GEOG
platona	platónico	
plaĉi	gustar	
plaĝo	playa	GEOG
plejofte	mayoritariamente	
plektaĵo	trenza	
plekti	trenzar	
plektro	plectro	MUZ
plena	lleno	FIG, MAT
plenaĝa	mayor de edad	
plendi	quejarse	
plendi	lamentarse	
plendo	queja	
plenumi	cumplir	
pleonasmo	pleonasmo	GRA
pleŭro	pleura	ANA
pli	más	
plibonigi	mejorar	
plie	además	
plimulto	mayoría	
plipezo	sobrepeso	
plivaloro	plusvalía	EKON
plonĝi	zambullirse	AVI, SPO
plonĝi	picar	AVI, SPO
plosivo	oclusiva	FON
pluki	recolectar	
pluko	recolección	
plumbo	plomo	KEM
pluskvamperfekto	pluscuamperfecto	GRA
pluso	más	FIG, KOMP, MAT, TIP
plutonio	plutonio	KEM
pluvegi	diluviar	
pluvego	aguacero	MET
pluvego	chubasco	MET
pluvego	chaparrón	MET
pluveti	lloviznar	
pluveti	chispear	
pluveto	llovizna	MET
pluvi	llover	
pluvo	lluvia	MET
pneŭmonio	neumonía	MED
poemo	poema	EVI, POE
poento	punto	SPO
poeto	poeta	POE
pogrande	al por mayor	EKON
pogrande	por mayoreo	EKON
poldero	pólder	AGR
polemiki	polemizar	
polemiko	polémica	
polico	policía	POL
poligloto	políglota	
polinoma	polinómico	
polinomo	polinomio	MAT
politeismo	politeísmo	REL
politikisto	político	POL
politiko	política	POL
polko	polca	MUZ
polmo	palma	ANA
polonio	polonio	KEM
pomalgrande	al por menor	EKON
pomalgrande	por menoreo	EKON
pontono	pontón	
popolo	pueblo	
pordego	portón	ARKI
pordisto	portero	
pordo	portal	ARKI, TEK
pordo	puerta	ARKI, TEK
posesivo	posesivo	GRA
postefiko	efecto secundario	
posteni	apostarse	
postenigi	apostar	
posteno	puesto	MIL
postgvardio	retaguardia	MIL
postiĉa	postizo	RAR
postiĉo	postizo	RAR
postpalato	velo	ANA
postsekvanta	después de la siguiente	EVI
posttagmezo	tarde	KAL
postulema	demandante	
postuli	demandar	
postulo	demanda	
postvango	nalga	ANA, ARK
poterno	poterna	ARKI, MIL
povi	poder	
povra	pobre	POE
pozitiva	positivo	ELE, FOT, GRA, MAT
poŝa	de bolsillo	
poŝo	bolsillo	FIG
poŝta	postal	
poŝtejo	correos	POSX
poŝtelefono	(teléfono) móvil	
poŝtelefono	celular	
poŝtisto	cartero	POSX
poŝto	correo	POSX
poŝto	correos	POSX
poŝtranĉilo	navaja de bolsillo	
poŝtuko	pañuelo	TEKS
poŭpo	popa	MAR
pragmatiko	pragmática	LIN
prahistorio	prehistoria	HIS, PRA, SCI
prazeodimo	praseodimio	KEM
precepto	precepto	RAR
precipa	principal	
precipe	principalmente	
preciza	preciso	
precizeco	precisión	
precizigi	precisar	
predikativo	predicativo	GRA
predikato	predicado	EVI, GRA, MAT
prefaco	prefacio	BELE
prefaco	prólogo	BELE
prefere	preferentemente	
preferi	preferir	
prefero	preferencia	
prefikso	prefijo	
preleganto	disertante	
preleganto	disertador	
prelegi	disertar	
prelego	disertación	PED
premaĵo	comprimido	MED
premaĵo	pastilla	MED
premsonĝo	pesadilla	
prepara	preparativo	
preparado	preparación	BIB, KRI
prepari	preparar	
prepucio	prepucio	ANA
presbitero	presbítero	BIB, HIS, KRI
preskaŭ	casi	
preskribi	prescribir	MED
preskribi	recetar	MED
preta	listo, -a	
preta	preparado, -a	
preta	dispuesto, -a	
pretigi	alistar	
pretigi	preparar	
prezenco	presente	GRA
prezenti	presentar	KOMP, SCI
prezenti	representar	KOMP, SCI
prezidanto	presidente	
prezidi	presidir	
prezo	precio	EKON
preĝejo	iglesia	REL
prifriponi	embaucar	
prilumi	iluminar	
primavero	primavera	POE, RAR
primitiva	primitivo	
prirabi	robar	
prisilenti	callar	
priskribi	describir	
prismo	prisma	MAT
problemo	problema	
procedi	proceder	
procesi	procesar	
proceso	proceso	JUR, SCI
procesoro	procesador	KOMP
procezo	proceso	KOMP, SCI, TEK
prociono	mapache	ZOO
produktado	producción	
produktaĵo	producto	
produktema	productivo	
produkti	producir	
produkto	producción	
produto	producto	MAT
profetaĵo	profecía	KOMUNE
profeti	profetizar	KOMUNE
profeto	profeta	KOMUNE, REL
profitema	lucrativo	
profiti	lucrar	
profiti	aprovechar	
prognozi	ponosticar	
prognozo	ponóstico	
programado	programación	KOMP, MAT
programi	programar	KOMP
programisto	programador	KOMP
programlingvo	lenguaje de programación	KOMP
programo	programa	KOMP
prohibi	prohibir	RAR
projekti	proyectar	TEK
projekto	proyecto	TEK
prokrasti	posponer	
proletaro	proletariado	
proleto	proletario	
promesi	prometer	
promeso	promesa	
prometio	prometio	KEM
pronomo	pronombre	LIN
prononci	pronunciar	
propeka kapro	chivo expiatorio	BIB, FRAZ
pekporta kapro	chivo expiatorio	BIB, FRAZ
pekofera kapro	chivo expiatorio	BIB, FRAZ
proporcia	proporcional	
proporcio	proporción	MAT
propozicio	proposición	EVI, GRA, MAT
propra	propio	
propraĵo	propiedad	EKON, JUR
proprigi	apropiar	
prosperi	prosperar	
prospero	prosperidad	
prostituitino	prostituta	
protaktinio	protactinio	KEM
protono	protón	FIZ
prototipo	prototipo	TEK
protruda	protuberante	MED
proverba	proverbial	
proverbo	proverbio	BELE
provi	intentar	FIG, RAR
provi	probar	FIG, RAR
providenco	providencia	
provizado	provisión	
provizaĵo	provisión	
provizi	proveer	
provizo	provisión	
proza	en prosa	FIG
proza	prosaico	FIG
prozo	prosa	
pseŭdonimo	seudónimo	
psikologia	psicológico	FIG
psikologiisto	psicológo	PSI
psikologio	psicología	FIG, PSI, SCI
puberto	pubertad	MED
pubertulo	púber	MED
publika ĝardeno	parque	HOR
pugo	trasero	
pugo	nalgas	
pugo	culo	
pulminflamo	neumonía	KOMUNE
pulminflamo	pneumonía	KOMUNE
pulso	pulso	BIO, MUZ
pumpi	bombear	
pumpi	comprimir	
pumpilo	bomba	
pumpilo	compresor	
pundo	libra	EKON
punika	púnico	
punto	encaje	TEKS
pupitro	pupitre	KRI
pupo	pupa	KOMUNE, SPO, ZOO
pura	puro	
purema	limpio	
purgatorio	purgatorio	KAT
purigi	limpiar	
purismo	purismo	
puto	pozo	
putra	podrido	
putra	putrefacto	
putri	pudrirse	FIG
puzlo	puzle	FIG
puŝi	empujar	
puŝo	empuje	
rabato	rebaja	EKON
rabato	descuento	EKON
rabi	robar	
rabisto	ladrón	
racionalisto	racionalista	FIL
radiano	radián	MAT
radikalo	raíz	GRA, KEM
radikalo	radical	GRA, KEM
radiko	raíz	BOT, EVI, FIG, GRA, MAT
radioaktiva	radiactivo	FIZ
radioaktiveco	radiactividad	FIZ
radiumo	radio	KEM
radono	radón	KEM
radŝuo	patín	SPO
rafini	refinar	FIG, KEM
raguo	ragú	KUI
rajo	raya	ZOO
raketo	cohete	AVI, MIL, SPO, TEK
ramadano	ramadán	ISL, KAL
rampi	reptar	FIG
rampi	arrastrarse	FIG
rampi	treparse	FIG
rampi	regarse	FIG
rampi	extenderse	FIG
rampi	arrastrarse	FIG
rampuloj	reptiles	ZOO
rando	borde	EVI, MAT
rando	orilla	EVI, MAT
rano	Rana de agua	ZOO
rano	rana	ZOO
ranunkolacoj	ranunculáceas	BOT
rapida	rápidamente	
rapida	velozmente	
rapida	aprisa	
rapida	rápido, -a	
rapida	veloz	
rapideco	rapidez	
rapideco	velocidad	
rapidi	apresurarse	
rapidi	darse prisa	
rapidi	apurarse	
rapidigi	apresurar	
rapidigi	dar velocidad	
rapidigi	apurar	
plirapidigi	apresurar	
plirapidigi	dar velocidad	
plirapidigi	apurar	
rapidiĝi	acelerarse	
rapidiĝi	hacerse más y más rápido	
rapido	Rapidez	FIZ
rapidumo	velocidad	TEK
rasti	rastrillar	AGR, HOR
rastilo	rastrillo	AGR, HOR
ratifi	ratificar	JUR
rato	rata	ZOO
ravi	encantar	
ravioloj	ravioli	KUI
razi	afeitar	
razilo	cuchilla de afeitar	
razilo	maquina de afeitar	
razilo	maquinilla de afeitar	
razisto	barbero	
reago	reacción	KEM
reala	real	
realaĵo	realidad	ARK
realigi	realizar	
realisma	realista	
realismo	realismo	BELA, FIL
realo	real	ARK, EKON, MAT
realo	realidad	ARK, EKON, MAT
recepto	receta	KUI, MED
recidivi	recidivar	
recidivo	recidiva	MED
recikligi	reciclar	EKOL
reciproka	recíproco	
reciproki	corresponder	
reciti	recitar	
redunda	redundante	
redundo	redundancia	KOMP, TEK
referendumo	referéndum	JUR
refleksiva	reflexivo	GRA, MAT
refleksivo	reflexivo	GRA
reflekti	reflejar	FIZ
reflekto	reflexión	FIZ, MAT
refrakti	refractar	FIZ
refrakto	refracción	FIZ
refreŝigaĵo	refresco	KUI
refreŝigi	refrescar	
regno	reino	BIO, FIG, POL
regula	regular	MAT
regularo	reglamento	
reguleco	regularidad	
regulesprimo	expresión regular	KOMP
reguligi	regular	
regulo	regla	
reklami	publicitar	
reklami	hacer publicidad	
reklami	hacer propaganda	
reklamisto	publicitario	EKON
reklamisto	publicista	EKON
reklamo	publicidad	EKON
reklamo	propaganda	EKON
reklamo	reclamo	EKON
rekordo	marca	SPO
rekordo	record	SPO
rekta	recto	ELE, EVI, GRA, MAT
rekta	directo	ELE, EVI, GRA, MAT
rekta	derecho	ELE, EVI, GRA, MAT
rekta	directo	ELE, EVI, GRA, MAT
rekta	recto	ELE, EVI, GRA, MAT
rekta intesto	recto	ANA
rektifi	rectificar	ARK, ELE, KEM, MAT
rektifilo	rectificador	ELE
rekto	recta	MAT
rektumo	recto	ANA
relajo	relé	ELE
relativa	relativo	GRA
relativismo	relativismo	FIL
remburi	rellenar	KOMUNE
remizo	garaje	ARKI
rendevui	reunirse	
rendevui	citarse	
rendevuo	reunión	
rendevuo	cita	
renio	renio	KEM
reno	riñón	ANA
rento	renta	EKON
reordigi	reordenar	
reprodukti	reproducir	
reputacio	reputación	
restadi	permanecer	
restado	permanencia	
restado	estancia	
restaĵo	resto	
resti	qué queda por hacer?	
resti	quedarse	
resti	permanecer	
resti	quedar	
resti	seguir	
resto	resto	MAT
restoracio	restaurante	
retadreso	dirección de internet	KOMP
retino	retina	ANA
retrovi	reencontrar	
retrovi	recuperar	
revelacio	revelación	
revolvero	revólver	MIL
rezignacio	resignación	
rezino	resina	BOT, KEM
rezisti	resistir	ELE, FIZ
rezisto	resistencia	ARK, ELE, EVI, FIZ
rezulti	resultar	
rezulti	dar como resultado	
rezulto	resultado	
reĝa	regio	
reĝa	real	
reĝi	reinar	FIG
reĝi	reinar	FIG
reĝidino	princesa	
reĝidino	infanta	
reĝido	príncipe	
reĝino	reina	SPO
reĝisoro	regidor	KIN, TEA
reĝisoro	director	KIN, TEA
reĝistro	registro	KOMP
reĝlando	reino	
reĝo	rey	FRAZ, POL, SPO
reĝo de reĝoj	rey de reyes	HIS, POL
reĝujo	reino	
ricevi	recibir	
rifuĝejo	refugio	
rifuĝi	refugiarse	
rifuĝinto	refugiado	
rifuĝo	refugio	
rigora	riguroso	
rikordo	registro	KOMP
rimedo	medio	
rimedo	remedio	
rimorso	remordimiento	RAR
ringofingro	dedo anular	ANA
rinocero	rinoceronte	
riparado	reparación	
ripari	reparar	
ripari	arreglar	
riparo	reparación	
ripo	costilla	ANA
ripozi	descansar	FIG
ripozi	reposar	FIG
riproĉi	reprochar	
riproĉo	reproche	
risorto	resorte	
ritaro	ritual	REL
ritlibro	libro ritual	REL
rito	rito	
rivero	río	FIG, GEOG
rizomo	rizoma	BOT
riĉa	rico	EKON
riĉigi	enriquecer	
riĉiĝi	enriquecerse	
riĉo	riqueza	
riĉulo	rico	
roboto	robot	FIG, TEK
rodio	rodio	KEM
roko	roca	
rokoko	rococó	ARKI, BELA
roma	romano	
romanco	romance	MUZ, POE
romaniko	románico	ARKI, BELA
romano	romano	BELE
romantismo	romanticismo	
rombo	rombo	MAT, ZOO
rombo	rombo	MAT, ZOO
romboido	romboide	MAT
romiano	romano	HIS
ronki	roncar	
ronki	roncar	
roso	rocío	MET
rostpano	tostada	KUI
rotacia akso	eje de rotación	MAT
rozario	rosario	FIG
rubeno	rubí	MIN
rubidio	rubidio	KEM
ruino	ruina	ARKE, FIG
ruino	ruina	ARKE, FIG
rukti	eructar	
rulbloko	polea	TEK
rulseĝo	silla de ruedas	
rulŝtuparo	escalera eléctrica	
rulŝuo	patín	SPO
rumo	ron	KUI
rutenio	rutenio	KEM
rutino	rutina	
ruĝa	rojo	
sabato	sábado	KAL
sablo	arena	
saboti	sabotear	
sabro	sable	MIL
sacerdoto	sacerdote	KRI
sadukeo	saduceo	HIS, REL
safiro	zafiro	MIN
safrano	azafrán	BOT, KUI
sago	flecha	MAT
saguo	sagú	KUI
sakramento	sacramento	KRI, REL
sakri	maldecir	
sakro	sacro	ANA
saksofono	saxofón	MUZ
saksofono	saxófono	MUZ
saksofono	saxo	MUZ
salajro	salario	EKON
salajrulo	asalariado	EKON
salamo	salami	KUI
salato	ensalada	FIG, KUI
salivo	saliva	
salo	sal	KEM, KUI
saltomortalo	salto mortal	SPO
salvo	salvo	MIL
sama	contemporáneo	
sama	al mismo tiempo	
sama	compatriota	
sama	correligionario	
sama	mismo	
samario	samario	KEM
samnito	samnita	HIS
samsencaĵo	sinónimo	LIN
samteamano	coequipero	SPO
samvalora	equivalente	
sanatorio	sanatorio	
sandalo	sandalia	TEKS
sandalo	huarache	TEKS
sangadulto	incesto	
sangalfluo	congestión	MED
sango	sangre	FIZL, GEN
sanktolei	dar los santos óleos	REL
sapo	jabón	
sapumi	enjabonar	
sarabando	zarabanda	MUZ
sardelo	anchoa	KUI, ZOO
sardelo	boquerón	KUI, ZOO
sardino	sardina	ZOO
sardino	pilchard	ZOO
sardona	sarcástico	RAR
sardona	sardónico	RAR
sarkasmo	sarcasmo	POE
sata	satisfecho	FIG
satano	satán	
satano	diablo	
satelito	satélite	AST
sateno	satén	TEKS
satiruso	sátiro	FIG, MIT
saturi	saturar	FIG
savi	salvar	
savo	salvación	
saŭco	salsa	
saŭnejo	sauna	
sciencfikcio	ciencia ficción	BELE, KIN
scienco	ciencia	SCI
scii	saber	
seaborgio	seaborgio	KEM
seanco	sesión	BELA, KIN, KOMP, MED
sebo	sebo	
sed	pero	
sedativo	sedante	MED
segi	serrar	
segilo	sierra	
segmento	segmento	MAT
segmento	segmento de recta	MAT
segmento	intervalo cerrado	MAT
seka	seco	FIG, TEK
sekalo	centeno	AGR, BOT
sekigi	secar	
sekiĝi	secarse	FIG
sekretariejo	secretaría	
sekretario	secretario	
sekshontemo	pudor	
sekshontemo	recato	
sekso	sexo	ARK, BIO, FIZL, GRA
sekso	sexo	ARK, BIO, FIZL, GRA
sekso	género	ARK, BIO, FIZL, GRA
sekstanto	sextante	MAR
seksto	sexto	MUZ
sektano	miembro de una secta	
sekto	secta	FIG, REL
sektoro	sector	EKON, MAT
sekundo	segundo	FIZ, KAL, MAT
sekvaĵo	la siguiente parte	ARK, MAT, MED
sekvaĵo	complicaciones	ARK, MAT, MED
sekve	consecuentemente	
sekve	por consecuencia	
sekvi	captar	FIG
sekvi	seguir	FIG
sekvi	comprender	FIG
sekvi	agarrar la onda	FIG
sekvi	ir después de	FIG
sekvi	seguirse de	FIG
sekvi	resultar de	FIG
sekvi	seguir	FIG
sekvo	consecuencia	
sekvojo	sequoia	BOT
seleno	selenio	KEM
semajno	semana	KAL
semantiko	semántica	
semi	sembrar	AGR, FIG
semiotiko	semiología	SCI
semiotiko	semiótica	SCI
semo	semilla	FIG
sen	sin	
senbarba	desbarbado, -a	
senbarba	chino, -a	
senbezona	innecesario	
senbrida	"sin riendas"	FIG
senbrida	desrriendado, -a	FIG
senbridigi	desrriendar	FIG
senco	sentido	EVI
senco	sentido	EVI
sencumo	sentido	
sendanka	ingrato	
sendependa	independiente	
sendi	enviar	FIG
sendieco	ateismo	REL
sendiismo	ateismo	REL
sendiulo	ateo	REL
senenhava	sin contenido	
senfamulo	desconocido	
senhara	calvo	
senhavigi	desposeer	
senhaviĝi	desposeerse	
senhavulo	desposeido	
senheredigi	desheredar	
senhoma	deshabitado	
senhomigi	deshabitar	
senhonta	sin vergüenza	
senhonta	desvergonzado, -a	
seniluziigi	desilusionar	
seniluziiĝi	desilusionarse	
senkonekte	autónomamente	KOMP
senkonekte	"fuera de linea"	KOMP
senkonekte	sin conexión	KOMP
senlaca	incansable	
senlima	ilimitado	
senmakula	inmaculada	
senpene	sin esfuerzo	
senpezigi	aliviar	
senpintigi	quitarle la punta	
senpintigi	gastarle la punta	
sensenca	sin sentido	
sensenca	sinsentido	
sensenca	absurdo	
sensenca	absurdo	
sensencaĵo	sinsentido	
sensencaĵo	absurdo	
senspiriĝi	quedarse sin respiración	
senspure	sin dejar rastro	
senspure	sin huella	
sensualismo	sensualismo	FIL
sentenco	sentencia	BELE
senvalora	sin valor	
senvestigi	desvestir	
senŝeligilo	pelador	KUI
senŝeligilo	abridor	KUI
sep	siete	
septembro	septiembre	
septembro	setiembre	
septeto	septeto	MUZ
septimo	séptimo	MUZ
serioza	serio	
servico	servicio	KUI
servila	obsequioso	RAR
serĉi	buscar	
serĝento	sargento	MIL
serĝo	sarga	TEKS
ses	seis	
sesio	sesión	
setaro	cítara	MUZ
sezono	estación	KAL
seĝo	escaño	
seĝo	silla	
sfera	esférico	
sfero	esfera	FIG, MAT
sfinkso	esfinge	FIG, MIT, RAR
sfinktero	esfínter	ANA
sibli	silbar	
sidvango	nalga	ANA
siesto	siesta	
sieĝi	sitiar	MIL
sieĝi	asediar	MIL
siglo	sigla	GRA, RAR
signifi	significar	
signifo	significado	FIG
sikismo	sikhismo	REL
silabo	sílaba	FON
silenta	silencioso	
silenti	callarse	FIG
silentigi	silenciar	
silentigi	acallar	
silentigi	hacer callar	
silento	silencio	
silfo	sílfide	MIT
silicio	silicio	KEM
silkeca	sedoso	
silko	seda	TEKS
silo	silo	AGR
silurio	silúrico	GEOL
simetriakso	eje de simetría	MAT
simio	simio	ZOO
simpatia	simpático, -a	
simpatii	simpatizar con	
simpatio	simpatía	
simulado	simulación	JUR, KOMP, MED
simuli	simular	JUR, KOMP, MED
simulilo	simulador	KOMP, TEK
sin direkti al	dirigirse a	
sin etendi	extenderse	
sin gvidi	guiarse	
sin trudi	imponerse	
sinedrio	sinedrio	HIS
sinergio	sinergia	FIL
singularo	singular	GRA
singulti	hipo	
sinonimo	sinónimo	
sintagma	sintagmático	LIN
sintagmo	sintagma	LIN
sintaksa	sintáctico	
sintakso	sintaxis	GRA
sintezi	sintetizar	
sintezilo	sintetizador	MUZ
sintezilo	sintetizadora	MUZ
sintezo	síntesis	FIL, KEM, KOMUNE
sinua	sinuoso	
sinuo	seno	
sinuo	ondulación	
sireno	sirena	FIG, MIT
sirenoj	sirenio	ZOO
siroko	siroco	MET
siropo	sirope	KUI
siropo	jarabe	KUI
sistemo	sistema de ecuaciones	FIZL, MAT
sistemo	sistema	FIZL, MAT
sistro	sistro	MUZ
situacio	situación	
skadrono	escuadrón	
skafaldo	andamio	KON
skalena	escaleno	MAT
skalo	escala	MUZ, TEK
skandio	escandio	KEM
skani	explorar	KOMP, TEK
skani	escanear	KOMP, TEK
skapolo	omoplato	ANA
skatolo	caja	
skermi	practicar la esgrima	
skiisto	esquiador	SPO
skio	esquí	SPO
skista	esquistoso	
skistoforma	esquistoso	
skisto	esquisto	MIN
skita	escita	
sklavo	esclavo	BIB, FIG, REL
skolo	escuela	
skoltismo	escultismo	
skolto	explorador	MIL, SPO
skolto	boy scout	MIL, SPO
skolto	explorador	MIL, SPO
skolto	exploradora	MIL, SPO
skombro	caballa	ZOO
skrapi	rascar	FIG
skrapi	raspar	FIG
skrapilo	rascador	
skrapilo	raspador	
skriba	escrito	
skribaĵo	escrito	
skribaĵo	escritura	
skribi	escribir	KOMP
skribisto	escriba	
skribmaŝino	máquina de escribir	
skribo	escritura	
skribtablo	escritorio	
skulpti	esculpir	BELA
slava	eslavo	
slava lingvo	lengua eslava	LIN
slavisto	eslavista	
slavo	eslavo	
snobo	esnob	
sobra	sobrio, -a	FIG
sociologia	sociológico	
sociologiisto	sociólogo	POL
sociologio	sociología	POL, SCI
sociologo	sociólogo	
sodo	sosa	KEM, TEK
sofismo	sofisma	
sofo	sofá	
softa	bajo	RAR
soifa	sediento	
soifi	tener sed	FIG
sojlo	umbral	FIG
solidara	solidario, -a	
solisto	solista	MUZ
solventa	solvente	EKON
solvi	disolver	FIG, KEM
solvi	resolver	FIG, KEM
solvi	solucionar	FIG, KEM
sonanto	sonante	FON
sonĝi	soñar	
sonĝo	sueño	
soriko	musaraña	ZOO
sorto	suerte	
sorto	destino	
sorto	sino	
sorĉi	embrujar	FIG
sorĉi	hechizar	FIG
sorĉi	hechizar	FIG
spageto	espagueti	KUI
spajro	pináculo	ARKI
speciala	especial	
speciale	especialmente	
specialisto	especialista	
specifa	específico	FIZ
specifi	especificar	
spektro	espectro	ARK, EVI, FIG, FIZ, MAT
spektro	espectro	ARK, EVI, FIG, FIZ, MAT
spekulacii	especular	EKON
spekulativa	especulativo	
spekulativi	especular	
spermatozoo	espermatozoide	BIO
spermo	esperma	ANA
sperta	experimentado, -a	
spertaĵo	práctica	
sperti	experimentar en	
sperti	experimentar	
sperto	pasada	
sperto	experiencia	
spezo	transacción	EKON
spino	columna vertebral	ANA, FIG, FIZ
spino	columna vertebral	ANA, FIG, FIZ
spioni	espiar	
spiono	espía	FIG, MIL, POL
spirado	respiración	FIZL
spiralo	espiral	MAT
spiri	respirar	FIG
spiro	respiración	
spoko	rayo (de rueda)	TEK
sprono	espuela	FIG
sprono	aguijón	FIG
sprono	estímulo	FIG
sproto	espadin	ZOO
spuro	huella	MAT
stablo	caballete	
stablo	mesa de trabajo	
stablo	chevalet	
stacidomo	estación	ARKI, FER
stadio	estadio	ARK, FIG, MIL, SPO
stadio	fase	ARK, FIG, MIL, SPO
stadio	etapa	ARK, FIG, MIL, SPO
stadiono	estadio	SPO
stagni	estancamiento	FIG
stagni	estancarse	FIG
stangeto	barilla	
stango	barra	TEK
stango	barilla	TEK
stani	estañar	
stano	estaño	KEM
statiko	estática	TEK
statistikaĵo	estadística	
statistiko	estadística	MAT
statuo	estatua	BELA
statuto	estatutos	
stelaro	constelación	AST
stelfiguro	constelación	AST
stelo	estrella	AST, FIG
stelo	estrella	AST, FIG
stelulo	estrella	BELA
stepo	estepa	GEOG
stereometrio	estereometría	ARK, MAT
sterko	abono	AGR
sterko	fertilizante	AGR
sternumo	esternón	ANA
stigmo	estigma	BOT
stilo	estil	
stokasta	estocástico	
stomako	estómago	ANA
stoplo	estopa	
straba	estrábico, -a	
strabe	estrábicamente	
strabe	de reojo	
strabi	ser estrábico, -a	FIG
strabi	ser bizco, -a	FIG
strabismo	estrabismo	
strabulo	bosojo, -a	
strabulo	virolo, -a	
strabulo	bizco, -a	
strando	playa	GEOG
stranga	extraño	
strategio	estrategia	FIG, MIL
strattelefono	(teléfono) público	
stratuso	estrato	MET
strebi	tener afán	MAT
strebi	afanarse	MAT
strebi	sentir inclinación	MAT
strebi	tender	MAT
strigo	buho	ZOO
striknino	estricnina	KEM, MED
striko	huelga	POL
strio	franja	KOMUNE
strofo	estrofa	POE
stroncio	estroncio	KEM
studi	estudiar	
studĝardeno	jardín botánico	HOR
eksperimentĝardeno	jardín botánico	HOR
stuki	estucar	
stuko	estuco	
stumpigi	amputar	
stumpo	muñón	MED
subakvigi	sumergir	
subaĉeti	sobornar	EKON
subaĉeti	comprar	EKON
subdosierujo	subdirectorio	KOMP
subgrupo	subconjunto	MAT
subita	súbito	
subita	repentino	
subjekto	sujeto	EVI, FIL, GRA
subjugigi	subyugar	
subjunktivo	subjuntivo	LIN
subordigi	subordinar	GRA
subordigilo	subjunción, conjunción subordinante	GRA
subprodukto	subproducto	
substantivo	sustantivo	GRA
substantivo	nombre	GRA
substitui	reemplazar	
substitui	sustituir	
substituo	reemplazo	MAT
substituo	sustituto	MAT
subtegmento	ático	
subtrahato	sustraendo	MAT
subtrahi	restar	MAT
subtraho	resta	MAT
subvesto	ropa interior	TEKS
suferi	sufrir	
sufikso	sufijo	GRA, KOMUNE, LIN
sufiĉa	suficiente	
sufiĉe	suficientemente	
sufiĉi	ser suficiente	
sugesti	sugerir	
sugesto	sugerencia	
sukerkano	caña de azúcar	BOT
suko	zumo	FIG, KUI
sukubo	súcubo	KAT
sukurado	el socorro	
sukurado	el socorrer	
sukuri	socorrer	
sukuristo	socorrista	
sukuranto	socorrista	
sulfuro	azufre	KEM
sultano	sultán	
sumera	sumerio	
sumero	sumerio	HIS, MAT
sumo	suma	MAT
sunbrunigi	broncear	
sunfloro	girasol	BOT
sunkalendaro	calendario solar	KAL
suna kalendaro	calendario solar	KAL
sunleviĝo	amanecer	KAL
suno	rayos solares	AST
suno	sol	AST
superbazaro	supermercado	EKON
superjaro	año bisiesto	KAL
superlativo	superlativo	GRA
supernatura	sobrenatural	
superstiĉo	superstición	
superŝuti	cubrir	FIG
superŝuti	recubrir	FIG
superŝuti	sobrecargar	FIG
suplementa	suplementario	MAT
suplemento	suplemento	MAT
supra sojlo	dintel	
supremo	límite superior	MAT
surda	sordo	FIG
surdulo	sordo	
surfi	surfear	KOMP, SPO
surhavi	llevar	
surhavi	portar	
surhavi	llevar puesto	
surmerkatigi	comercializar	EKON
suro	pantorrilla	ANA
surprizi	sorprender	
surrealismo	surrealismo	EVI
surtabla komputilo	computadora de escritorio	KOMP
survango	bofetada	
vangobato	bofetada	
susuri	susurrar	
susuro	susurro	
suverena	soberano, -a	
suvereneco	soberanía	
suvereno	soberano	
suĉi	chupar	
suĉigi	dar de mamar	
suĉilo	chupete	
suĉilo	pepe	
suĉinfano	lactante	
tablo	mesa	
tabua	tabú	
tabuo	tabú	FIG, REL
tagmezo	mediodía	KAL
tagnoktegaleco	equinoccio	AST, KAL
tago	día	KAL
tagordo	orden del día	
tajloro	sastre	TEKS
tajpaĵo	texto mecanografiado	
tajpaĵo	Escrito a máquina	
tajpi	Escribir a máquina	TEK, TIP
tajpi	Mecanografiar	TEK, TIP
tajpi	Tipear	TEK, TIP
tajpilo	Máquina de escribir	TEK
tajpisto	Mecanógrafo	
taksi	estimar	ARK
taksi	apreciar	ARK
talanto	talento	EKON, HIS
taliumo	talio	KEM
tampono	tampón	
tandemo	tándem	
tangao	tanga	TEKS
tani	curtir	TEK
tanilo	tanino	TEK
tanino	tanino	KEM
tankao	tanca	POE
tanko	tanque	MIL
tantalo	tántalo	KEM
tao	tao	FIL
tapioko	tapioca	KUI
tarifi	poner la tarifa de	EKON
tarifi	fijar la tarifa de	EKON
tarifo	tarifa	EKON
taso	taza	KUI
taverno	taberna	
tavoligi	estratificar	
tavolkuko	hojaldre	KUI
tavolo	estrato	POL
tavolo	capa	POL
tavolo	estrato	POL
tavolo	clase	POL
teamo	equipo	SPO
tegi	recubrir	
tegi	forrar	
tegmento	tejado	
tego	recubrimiento	
tego	forro	
teino	teína	KEM, MED
tekilo	tequila	KUI
teknecio	tecnecio	KEM
tekruĉo	tetera	
teksaĵo	tela	ANA, FIG, TEKS
teksaĵo	tejido	ANA, FIG, TEKS
teksi	tejer	FIG, TEKS
telefoni	telefonear	
telefoni	hablar por teléfono	
telefonnumero	número de teléfono	
telefonnumero	número telefónico	
telefono	teléfono	ELET, TEL
telegrafo	telégrafo	ELET, TEL
telegramo	telegrama	TEL
teleregilo	mando a distancia	
telero	plato	
televidi	ver la televisión	
televidilo	televisor	
televido	televisión	TEK, TEL
teluro	telurio	KEM
temaro	temario	
tembro	timbre	FON, MUZ
temi	tratar (sobre)	
temi	tratarse (de)	
temo	tema	
temo	asunto	
tempesto	tormenta	MET
tempesto	tempestad	MET
tempio	sien	ANA
templo	templo	FIG
tempo	tiempo	EVI, FIZ, GRA, KAL, MUZ
tempo	tiempo	EVI, FIZ, GRA, KAL, MUZ
tempo	tiempo	EVI, FIZ, GRA, KAL, MUZ
temporalo	hueso temporal	ANA
tendaro	campamento	FIG
tendeno	tendón	ANA
tendo	tienda	ARKI
tendro	ténder	FER
tendumi	acampar	
tenebro	tenebrosidad	POE
tenera	afectuoso(a)	
tenera	tierno(a)	
tenere	afectuosamente	
tenere	tiernamente	
tenoro	tenor	MUZ
teoremo	teorema	MAT
teorio	teoría	
tera	terrestre	
terapio	terapia	MED
terbio	terbio	KEM
terenregistro	catastro	JUR
teretaĝo	planta baja	ARKI
terglobo	globo terráqueo	
teritorio	territorio	POL
terkapo	cabo	GEOG
terkrusto	corteza terrestre	GEOL
terkulturo	agricultura	AGR
termika	térmico	FIZ
termika	térmica	FIZ
terminalo	terminal	AVI, KOMP, MAR
terminaro	diccionario especializado	LIN
termino	término	LIN
terminologio	terminología	LIN
termometro	termómetro	
terni	estornudar	
ternukso	cacahuate	BOT
tero	tierra	
terorismo	terrorismo	POL
teroristo	terrorista	
teroro	terror	POL
terpeĉo	asfalto	KOMUNE
terpomfingro	papas a la francesa	KUI
terpomfloko	papas fritas	KUI
terpomo	papa	KUI
terpomo	patata	KUI
tertremo	temblor	GEOL
terura	terrible	FIG
teruraĵo	algo terrible	
terure	terriblemente	FIG
teruri	aterrorizar	
teruro	terror	
tervermo	lombriz	
testo	test	PSI, TEK
tibio	tibia	ANA
tikli	hacer cosquillas	
tiko	tic	MED, TEKS
timi	temer	
tinuso	atún	ZOO
tio estas	es decir	
tio estas	o sea	
tiraljoro	francotirador	MIL
tirharmoniko	acordeón	MUZ
titano	titanio	AST, KEM, MIT
to-ĉemizo	camiseta	TEKS
togo	toga	TEKS
tohuvabohuo	agitación	RAR
tokato	tocata	MUZ
tolerebla	tolerable	
tolerema	tolerante	
toleri	tolerar	
tolueno	tolueno	KEM
tombmonteto	túmulo	ARKE
tombomonumento	mausoleo	ARKI
tomba monumento	mausoleo	ARKI
tomismo	tomismo	FIL
tonalo	tonalidad	MUZ
tonsilo	amígdala	ANA
topazo	topacio	
topologia	topológico	MAT
topologio	topología	MAT
torako	tórax	ANA, ZOO
toreadoro	torero	
torio	torio	KEM
torpedo	torpedo	MIL
tortiljo	tortilla	KUI
torturi	torturar	
torturisto	torturador	
torturo	tortura	FIG, JUR
tosti	brindar	
tosto	brindis	KUI
totemismo	totemismo	
totemo	tótem	
traakvigi	irrigar	AGR
trajno	tren	FER, MIL, TEK
trajno	columna	FER, MIL, TEK
trajto	facción	
trajto	rasgo característico, -a	
trajto	rasgo	
tramo	tranvía	ARK, FER
tranco	trance	FIL
transformatoro	transformador	ELE
transira	transitivo	GRA
transitiva	transitivo	GRA, MAT
transloki	trasladar	
transloĝiĝi	mudar	
transmara	ultramarino	
transruĝa	infrarrojo	FIZ, TEK
transskribi	transcribir	
transurania	transuránico	KEM
tranĉeo	trinchera	MIL
tranĉi	cortar	FIG
tranĉi	cortar	FIG
tranĉi	romper	FIG
tranĉilo	cuchilla	
tranĉilo	cuchillo	
tranĉilo	navaja	
tranĉo	cortadura	MAT
tranĉodento	incisivo	ANA
tranĉa dento	incisivo	ANA
trapezo	trapecio	MAT, SPO
travadejo	vado	
travadi	vadear	
travestii	parodiar	
travidebla	transparente	
traĥeo	tráquea	ANA, BOT, ZOO
traĥomo	tracoma	MED
traŭmato	trauma	MED, PSI
tre	muy	
tre	mucho	
treege	extremadamente	
treege	muchísimo	
trejni	entrenar	SPO
trembrili	parpadear	
tremi	temblar	
tribunalo	tribunal	JUR
triciklo	triciclo	
tridento	tridente	
triglifo	triglifo	ARKI
triglifo	tríglifo	ARKI
triglo	rubios	ZOO
trinki	beber	FIG
tritiko	trigo	AGR, BOT
troa	excesivo	
troaĵo	exceso	
troe	excesivamente	
trombono	trombón	MUZ
trompi	engañar	
trompi	hacer trampa	
tropika	tropical	
tropiko	trópico	
troti	trotar	
troti	ir al trote	
trovi	encontrar	
troviĝi	encontrarse	
trovo	encuentro	
trubaduro	trovador	POE
trudi	imponer	
trudiĝi	imponerse	
trulo	palustre	KON
trupo	tropa	MIL, PED, TEA
tujpreta	instantáneo	KUI
tulio	tulio	KEM
tulipo	tulipán	BOT
tunelo	túnel	
tuniko	túnica	TEKS
turbano	turbante	TEKS
turismo	turismo	
turmenta	tormentoso	
turmenti	atormentar	FIG
turmenti	mortificar	FIG
turmentiĝi	atormentarse	
turmento	tormento	
turo	torre	ARKI, SPO
tusi	toser	
tuta	todo	
tutaĵo	totalidad	
tute	totalmente	
tutslavismo	paneslavismo	
ujo	contenedor	
ukazo	ucase	
ulano	ulano	HIS, MIL
ulcero	úlcera	MED
ulekso	aulaga	BOT
ulgenro	género animado	GRA
ulmacoj	ulmáceas	BOT
ulmo	olmo	BOT
ulno	codo	
ulno	cúbito	
ultimato	ultimátum	POL
ultramaro	ultramar	
ululi	ulular	
ululi	aullar	
umbeliferoj	umbelíferas	BOT
umbelo	umbela	BOT
umbilika ŝnuro	cordón umbilical	ANA
umbiliko	ombligo	ANA, BOT
unco	onza	
ungvento	ungüento	MED
uniformo	uniform	TEKS
unika	único	
universa	universal	
universala	universal	
universo	universo	
unu	uno	
unuanime	unánimemente	
unuforma	uniforme	
unuforme konverĝa	uniformemente convergente	MAT
ununombro	singular	GRA
unuokula	tuerto	
uragana	huracanado	
uragano	huracán	FIG, MET
urala-altaja lingvofamilio	grupo uralo-altaico	LIN
uranio	uranio	KEM
urbo	ciudad	ARKI
uretero	uréter	ANA
uretro	uretra	ANA
urini	orinar	
uro	uro	ZOO
urodeloj	urodelos	ZOO
urogalo	urogallo	ZOO
urso	oso	ZOO
urtikacoj	urticáceas	BOT
urtiko	ortiga	BOT
urĝi	urgir	
usona	estadounidense	
usona	norteamericano	
utero	útero	ANA
utero	matriz	ANA
utila	útil	
utopio	utopía	
uverturo	obertura	MUZ
uvulo	úvula	ANA
uzi	usar	
uzi	utilizar	
uzukapi	usucapir	EKON, JUR
uzukapo	usucapión	
uzuro	usura	EKON
uzurpi	usurpar	JUR
vadejo	vado	
vadi	vadear	
vaflo	barquillo	KUI
vagi	vagar	
vagi	deambular	
vagino	vagina	ANA
vagonaro	tren	FER
vagono	vagón	FER
vakcinado	vacunación	MED
vakcini	vacunar	MED
vakcino	vacuna	MED
vakero	vaquero	AGR
vaki	estar vacío	
vaki	estar libre	
vaksi	encerar	
vakso	cera	
vakuigi	vaciar	
vakuo	vacío	FIZ
valento	valencia	KEM, LIN
valento	valencia	KEM, LIN
valerianacoj	valerianáceas	BOT
valida	válido	JUR
validi	tener vigor	JUR
validi	tener vigencia	JUR
valizo	maleta	
valo	cuenca	GEOG
valo	valle	GEOG
valono	valón	
valora	valioso	
valoraĵo	valor	
valori	valer	EKON
valori	valorar	EKON
valori	merecer la pena	EKON
valori	valer	EKON
valori	valer	EKON
valori la penon	valer la pena	
valoro	valor	KOMP, MAT
valsi	vals	
valvo	valva	BOT, ELE, TEK, ZOO
valvo	váalvula	BOT, ELE, TEK, ZOO
valvo	valva	BOT, ELE, TEK, ZOO
valvo	ventalla	BOT, ELE, TEK, ZOO
vampiro	vampiro	FIG, ZOO
vana	inútil	
vana	ineficaz	
vana	infructuoso	
vana	vano	
vanadio	vanadio	KEM
vanado	vanadio	KEM
vandalo	vándalo	FIG, HIS
vando	tabique	ANA, ARKI, BIO
vane	en vano	
vane	vanamente	
vane	ineficazmente	
vane	infructuosamente	
vaneco	vanidad	
vaneco	inutilidad	
vaneco	ineficacia	
vanelo	avefría	ZOO
vanelo	ave fría	ZOO
vangharoj	patillas	
vango	mejilla	ANA
vanigi	inutilizar	
vanigi	quitar importancia	
vanilo	vainilla	BOT, KUI
vapora	vaporoso	
vaporigi	evaporar	
vaporiĝi	evaporarse	
vaporo	vapor	
vaporŝipo	barco de vapor	MAR
varbi	reclutar	MIL, POL
variablo	variable	KOMP, MAT
variacio	variación	MUZ
varianca devio	desviación típica	MAT
varianco	varianza	MAT
varianta	variable	MAT
varianto	lectura	ARK, MAT, TIP
varianto	variante	ARK, MAT, TIP
variema	voluble	
variema	variable	
varieteo	variedades	TEA
varii	variar	
varii	cambiar	
variko	variz	MED
varma	caliente	FIG
varmeta	templado	
varmigi	calentar	
varmo	calor	FIZ
varo	mercancía	EKON
varti	cuidar	
vartistino	niñera	
vartistino	nana	
vaska	vasco	
vasko	vasco	
vazelino	vaselina	
vefto	trama	TEK, TEKS
veki	despertar	FIG
vekiĝi	despertarse	
veko	despertar	
veko	despertamiento	
velaro	velar	FON
veldi	soldar	TEK
velka	marchito	
velki	marchitarse	FIG
velo	vela	ANA, FON, MAR
velstango	mástil	MAR
velŝipo	velero	MAR
velŝipo	barco de vela	MAR
vendredo	viernes	KAL
venena	venenoso	FIG
veneni	envenenar	FIG
veneno	veneno	
venerea	venéreo	MED
venerea	de transmisión sexual	MED
vento	viento	FIG, MET
venĝemo	vengativo	
venĝo	venganza	
ver(aĵ)o	verdad	
vera	verdadero	
vera	de verdad	
verando	veranda	ARKI
verbasko	verbascum	BOT
verbo	verbo	GRA
verda	verde	
vere	en verdad	
vere	verdaderamente	
vere	realmente	
vermiĉelo	fideo	KUI
vermo	gusano	ZOO
vertico	vértice	MAT
vespermanĝo	cena	KUI
vespermanĝo	merienda	KUI
vestaĵo	prenda	TEKS
vestejo	vestidor	TEKS
vesti	vestir	FIG, TEKS
vesto	vestido	TEKS
vetero	tiempo	MET
veterprognozo	ponóstico meteorológico	MET
veti	apostar	SPO
veto	apuesta	
veziko	vesícula	ANA
veziro	visir	
vi	tú	
vi	usted	
vi	vosotros	
vi	ustedes	
viando	carne	FRAZ
vidi	ver	
vido	vista	ARK
vido	aspecto	ARK
vidvino	viuda	
vidvo	viudo	
vigili	velar	
viktimo	víctima	FIG
viktualio	vituallas	RAR
vilaĝo	pueblo	ARKI
vindozulo	usuario de Windows	KOMP
vinjeto	viñeta	TIP
vintro	invierno	KAL
violenta	violento, -a	
violento	violencia	
vipi	azotar	FIG
vipo	látigo	FIG
vira	masculino	POE
vira	masculino	POE
virabelo	zángano	ZOO
virbovo	toro	AGR
virgenro	género masculino	GRA
vira genro	género masculino	GRA
virina	femenino	
virino	mujer	
viro	macho	
viro	hombre	
viro	hombre	
virta	virtuoso	
virto	virtud	
virtuala	virtual	FIL
virtuozo	virtuoso	MUZ
viruso	virus	BAK, KOMP
virĉevalo	caballo macho	
viskio	whisky	KUI
viskio	güisqui	KUI
visko	muérdago	BOT
vitamino	vitamina	BIO, MED
vitrego	vitral	
vitro	vidrio	
viva gazeto	revista teatral	TEA
vivisekcio	vivisección	MED
vivoĉambro	sala	
vizaĝo	cara	ANA
vizaĝo	rostro	ANA
vizi	visar	
viziero	visera	TEKS
vizio	visión	
viziti	visitar	
vizito	visita	
vizo	visa	POL
viŝtuko	paño	TEKS
vodevilo	vodevil	TEA
vojaĝi	viajar	
vojaĝo	viaje	
vojkruciĝo	encrucijada	TRA
vojo	camino	FIG, MAT, TRA
vokalo	vocal	FON
vokativo	vocativo	GRA
voki	llamar	
vokkazo	vocativo	GRA
volapuko	volapuk	ESP, LIN
volbo	bóveda	ARKI
vole nevole	velis nolis	
vole nevole	quieras o no quieras	
volframo	wolframio	KEM
volframo	tungsteno	KEM
volframo	volframio	KEM
volframo	wólfram	KEM
voli	querer	
volitivo	volitivo	GRA
volo	voluntad	
volto	volt	ELE
volto	voltio	ELE
volumenaĵo	volumen	ARK, MAT, TEK
volumeno	volumen	FIZ, MAT
volumo	volumen	TIP
volupto	voluptuosidad	
volvi	enrollar	
vomi	vomitar	FIG
vomi	vomitar	FIG
vomi	escupir	FIG
vori	devorar	
vortaro	diccionario	LIN
vortico	vórtice	
vortico	remolino	
vortico	torbellino	
vorto	palabra	KOMP, LIN
vortoprovizo	vocabulario	LIN
vortprovizo	vocabulario	LIN
vosto	cola	FIG, ZOO
vosto	rabo	FIG, ZOO
vosto	cola	FIG, ZOO
vosto	cola	FIG, ZOO
vosto	cola	FIG, ZOO
voti	hacer un voto o votos	
voti	prometer	
voto	voto	REL
voĉa	sonoro	FON
voĉdoni	votar	
voĉi	votar	
voĉo	voz	GRA
vuali	velar	FIG
vuali	ocultar	FIG
vualo	velo	FIG, TEKS
vulgara	vulgar	
vulkanizi	vulcanizar	TEK
vulkano	volcán	GEOG, GEOL
vulpo	zorro	ZOO
vulturo	buitre	ZOO
vulvo	vulva	ANA
vundi	herir	FIG
vundo	herida	MED
zarzuelo	Zarzuela	MUZ
zebro	cebra	ZOO
zebuo	cebú	ZOO
zefiro	céfiro	MET
zeloto	celota	HIS, REL
zenito	cenit	AST, FIG
zenito	zenit	AST, FIG
zibelo	marta cebellina	
zigofilacoj	cigofiláceas	BOT
zigzagi	zigzaguear	
zigzago	zigzag	
zingibracoj	cingiberáceas	BOT
zingibro	jengibre	BOT
zinki	galvanizar	
zinko	cinc	KEM
zinko	zinc	KEM
zipo	cremallera	TEKS
zipo	cierre	TEKS
zirkonio	circonio	KEM
zirkonio	zirconio	KEM
zodiako	zodiaco	AST
zodiako	zodíaco	AST
zono	cinturón	FIG, GEOG, MAT, TEKS
zono	cintura	FIG, GEOG, MAT, TEKS
zono	talle	FIG, GEOG, MAT, TEKS
zoofito	zoófito	ZOO
zoologiisto	zoólogo	SCI, ZOO
zoologio	zoología	SCI, ZOO
zoologo	zoólogo	
zorgi	preocupar	
zuavo	zuavo	MIL
zumi	zumbar	
zumi	canturrear	
Ĉashundoj	Los Perros de Caza	AST
Ĉccirc;inujo	China	GEOG
Ĉccirc;izilo	Cincel	
Ĉilio	Chile	
ĉagrena	molesto	
ĉagreni	molestar	
ĉajoto	chayota	BOT, KUI
ĉajoto	chayote	BOT, KUI
ĉako	chacó	TEKS
ĉakono	chacona	MUZ
ĉambristo	camarista	
ĉambro	habitación	POL
ĉambro	cuarto	POL
ĉambro	cámara	POL
ĉambro	cámara	POL
ĉampano	champán	KUI
ĉampinjono	champiñón	BOT
ĉampiono	campeón	EVI
ĉantaĝi	chantajear	JUR
ĉapelo	sombrero	GRA, KOMP, TEKS, TIP
ĉapelo	sombrero	GRA, KOMP, TEKS, TIP
ĉapitro	capítulo	TIP
ĉar	porque	
ĉarlatano	charlatán	
ĉarma	encantador	
ĉarmi	encantar	
ĉarmo	encanto	
ĉaro	carro	
ĉaro	carruaje	
ĉarpentisto	carpintero	
ĉasi	cazar	FIG
ĉasio	chasís	TEK
ĉasisto	cazador	
ĉasta	casto	
ĉefa	principal	MAT
ĉefduko	archiduque	
granda duko	archiduque	
ĉefe	principalmente	
ĉefo	jefe	
ĉefprocesoro	procesador principal	KOMP
ĉefurbo	capital	FIG, POL
ĉeko	cheque	EKON
ĉelaro	tejido	BIO
ĉelo	celda	ARKI, BIO, POL
ĉelo	célula	ARKI, BIO, POL
ĉelo	célula	ARKI, BIO, POL
ĉemizo	camisa	TEKS
ĉenero	eslabón	
ĉeni	encadenar	
ĉeno	cadena	FIG, KOMP, MAT, TEK
ĉerizo	cereza	
ĉerizujo	cerezo	BOT
ĉerko	ataúd	
ĉerkveturilo	coche fúnebre	
ĉesi	cesar	
ĉevalaĵo	carne de caballo	KUI
ĉevalejo	caballeriza	AGR
ĉevalido	potro	
ĉevalido	potranco	
ĉevalino	yegua	
ĉevalo	caballo	SPO, ZOO
ĉevalpovo	caballo de fuerza	FIZ, TEK
ĉiam	siempre	
ĉie	por todas partes	
ĉie	en todas partes	
ĉielo	cielo	REL
ĉifonfiguro	espantapájaros	AGR
ĉifri	cifrar	KOMP, MIL
ĉifro	cifra	KOMP, MIL
ĉifro	código	KOMP, MIL
ĉimpanzo	chimpancé	ZOO
ĉina inko	Tinta china	
ĉino	chino	
ĉio	todo	
ĉipso	papas fritas	KUI
ĉirkaŭbraki	abrazar	
ĉirkaŭkovri	recubrir	
ĉirkaŭpalpi	buscar a tientas	
ĉirpi	chirriar	
ĉiujara	anual	
ĉizi	cincelar	BELA, BELE, TEK
ĉizilo	cincel	TEK
ĉiĉerono	guía	
ĉj	-ito	
ĉokolado	chocolate	KUI
ĉu	acaso	
Ĝgcirc;emeloj	Géminis	AST
Ĝgcirc;irafo	Jirafa	
ĝangalo	jungla	FIG, GEOG
ĝardenisto	jardinero	HOR
ĝardeno	jardín	HOR
ĝazbando	grupo de jazz	ARK, MUZ
ĝemelo	gemelo	
ĝenerala	general	
ĝenerala	genérico	
ĝenerale	generalmente	
ĝenerale	genéricamente	
ĝenerale	en general	
ĝeneraligi	generalizar	
ĝeni	molestar	
ĝeni	estorbar	
ĝentila	gentil	
ĝentileco	gentileza	
ĝentilhomo	caballero	ARK
ĝentlemano	caballero	
ĝermanaj lingvoj	lenguas germánicas	LIN
ĝermano	germano	HIS
ĝermi	germinar	FIG
ĝermo	germen	BOT, FIG
ĝi	ello	
ĝibaĵo	protuberancia	
ĝibigi	jorobar	
ĝibo	joroba	ANA, ZOO
ĝibulo	jorobado	
ĝigo	giga	MUZ
ĝino	ginebra	ISL, KUI
ĝinzo	(pantalones) vaqueros	TEKS
ĝinzo	jeans	TEKS
ĝinzo	pantalón de mezclilla	TEKS
ĝirafo	jirafa	ZOO
ĝis	hasta	
ĝis	hasta	
ĝisfunde	hasta el fondo	FIG
ĝoja	alegre	
ĝoja	contento, -a	
ĝoja	feliz	
ĝoji	estar feliz	
ĝojigi	alegrar	
ĝojo	alegría	
ĝui	disfrutar	
ĝusta	justo	
ĝusta	adecuado	
ĝuste	justamente	
Ĥarono	Caronte	AST, BELE, MIT
Ĥhcirc;ameleono	Cameleón	
Ĥhcirc;inujo	China	ARK, GEOG
ĥameleono	camaleón	ZOO
ĥano	kan	HIS, POL
ĥanujo	kanato	HIS, POL
ĥaoso	caos	FIG, MIT
ĥemiaĵo	producto químico	
ĥemio	química	KEM, SCI
ĥimero	quimera	FIG, MIT
ĥimo	quimo	BIO, FIZL, MED
ĥinino	quinina	MED
ĥino	chino	ARK
ĥirurgiisto	cirujano	KIR
ĥirurgio	cirugía	KIR, MED
ĥirurgo	cirujano	MED
ĥitino	quitina	BIO, KEM
ĥolecistito	colecistitis	MED
ĥolero	cólera	MED
ĥolesterolo	colesterol	BIO, KEM
ĥordo	cuerda dorsal	ZOO
ĥorduloj	cordados	ZOO
ĥoreo	corea	MED
ĥoreo	baile de San Vito	MED
ĥorjambo	coriambo	POE
ĥoro	coro	MUZ, TEA
ĵJcirc;ulo	julio	FIZ
ĵaketo	chaqué	TEKS
ĵaketo	chaqueta	TEKS
ĵako	levita	ARK, ELE, TEKS
ĵaluza	celoso	
ĵaluzi	estar celoso (de)	
ĵaluzi	sentir celos (de)	
ĵaluzio	persiana	ARKI
ĵaluzo	celos	
ĵargono	jerga	ARK
ĵazbando	grupo de jazz	MUZ
ĵazo	jazz	MUZ
ĵaŭdo	jueves	KAL
ĵeleo	gelatina	KUI
ĵeti	lanzar	
ĵibo	foque	MAR
ĵinzo	(pantalones) vaqueros	TEKS
ĵinzo	jeans	TEKS
ĵinzo	pantalón de mezclilla	TEKS
ĵipo	jeep	AUT
ĵokeo	jockey	SPO
ĵokero	comodín	KOMP, SPO
ĵongli	hacer malabarismos	FIG, SPO
ĵonglisto	malabarista	
ĵudo	judo	SPO
ĵuraso	período jurásico	GEOL
ĵuri	jurar	
ĵurio	jurado	JUR
ĵurnalisto	periodista	
ĵurnalo	periódico	TIP
ĵuro	juramento	
ĵurpeti	suplicar	
ĵurrompi	cometer perjurio	
ĵurrompi	perjurar	
Ŝscirc;afo	Aries	AST
ŝablono	plantilla	FIG, TEK
ŝablono	patron	FIG, TEK
ŝablono	modelo	FIG, TEK
ŝablono	estereotipo	FIG, TEK
ŝafo	oveja	FIG, ZOO
ŝafto	eje transmisor	TEK
ŝafto	árbol	TEK
ŝajni	parecer	
ŝakalo	chacal	ZOO
ŝakludo	ajedrez	SPO
ŝako	jaque	SPO
ŝakpeco	pieza	SPO
ŝaktabulo	tablero de ajedrez	SPO
ŝalo	chal	TEKS
ŝamanismo	chamanismo	REL
ŝampuo	champú	
ŝankro	chancro	MED
ŝanĝa	cambiante	EVI
ŝanĝi	cambiar	
ŝanĝiĝema	cambiante	
ŝanĝiĝi	cambiar	
ŝati	gustar	
ŝatokupo	afición	
ŝatokupo	pasatiempo	
ŝaŭmi	espumar	
ŝaŭmo	espuma	FIG
ŝelko	tirantes	TEKS
ŝelo	corteza	BOT, KOMP
ŝelo	piel	BOT, KOMP
ŝelo	cáscara	BOT, KOMP
ŝelo	caparazón	BOT, KOMP
ŝi	ella	
ŝildo	escudo	HIS, MIL, TRA
ŝilingo	chelín	
ŝinko	jamón	KUI
ŝintoo	sintoísmo	REL
ŝlagro	éxito	MUZ
ŝlimo	cieno	FIG
ŝmiri	untar	EKON, FIG
ŝoforo	chófer	TRA
ŝovi	deslizar	
ŝovinismo	chovinismo	
ŝovpordo	puerta deslizable	ARKI
ŝpato	laya	AGR
ŝprucfenestro	ventana emergente	KOMP
ŝranko	armario	
ŝraŭbborilo	machuelo	TEK
ŝraŭbi	atornillar	
ŝraŭbigi	terrajar	TEK
ŝraŭbigilo	terraja	TEK
ŝraŭbilo	desarmador	TEK
ŝraŭbingo	tuerca	TEK
ŝraŭbkanelo	cuerda	TEK
ŝraŭbo	tornillo	TEK
ŝraŭbpaŝo	paso	TEK
ŝraŭbŝlosilo	llave	TEK
ŝtata	estatal	
ŝtato	estado	POL
ŝteli	robar	
ŝteli	hurtar	
ŝtelisto	ladrón	
ŝtelisto	ratero	
ŝtofo	tela	ARK, TEKS
ŝtofo	tejido	ARK, TEKS
ŝtonoleo	petróleo	
ŝtuparo	escalera	ARKI
ŝtupetaro	escalerilla	
ŝtupo	escalón	FIG
ŝuldi	deber	EKON
ŝuldo	deuda	EKON
ŝultro	hombro	ANA
ŝuo	zapato	TEKS
ŝuti	cargar	FIG, KOMP
ŝviti	sudar	FIG
ŝvito	sudor	ANA, MED
diskutebla	discutible	
kontraŭdiskutebla	discutible	
