Adamo	Adam	BIB, NOM, PERS
Adam	Adam	BIB, NOM, PERS
Afrodito	Afrodita	MIT
Afrodita	Afrodita	MIT
Aglo	Àguila	AST
Alaho	A·là	ISL, REL
Alasko	Alaska	GEOG, POL
Aleutaj Insuloj	Illes Aleutianes	GEOG
Amsterdamo	Amsterdam	GEOG
Antverpeno	Anvers	GEOG
Arnhemo	Arnhem	GEOG
Arturo	Artur	NOM
Azio	Àsia	GEOG
Babelturo	torre de Babel	BIB, ESP, FRAZ
Babilonio	Babilònia	HIS
Baltiko	Bàltic	ARK, GEOG
Belgio	Bèlgica	GEOG
Belgujo	Bèlgica	GEOG
Bruselo	Brusse·les	GEOG
Cicerono	Ciceró	BELE, PERS
Danubo	Danubi	GEOG
Eduardo	Eduardo	NOM
Esperanto	esperanto	LIN, PERS
Eŭfrato	Eufrates	GEOG
Fenicio	Fenícia	GEOG, HIS
Fiŝoj	peixos	AST
Francio	França	GEOG
Francujo	França	GEOG
Germanio	Alemanya	GEOG
Germanujo	Alemanya	GEOG
Granda Ursino	Ossa Major	AST
Hieronimo	Jeroni	NOM
Homero	Homer	PERS
Hungarujo	Hongria	GEOG
Jakobio	Jacobi	PERS
Jerusalemo	Jerusalem	GEOG
Jordanio	Jordània	GEOG
Kankro	cáncer	AST
Kankro	cranc	AST
Karesmo	quaresma	KAT
Kaspio	Mar Caspi	GEOG
Konstantinopolo	Constantinoble	HIS
Korano	Alcorà	ISL, REL
Koreujo	Corea	GEOG
Luksemburgo	Luxemburg	GEOG
Malgrand-Azio	Àsia Menor	GEOG
Malgrand-Azio	Anatòlia	GEOG
Marko	Marc	NOM
Mezopotamio	Mesopotàmia	GEOG, HIS
Muhamado	Mahoma	HIS, ISL, NOM, PERS, REL
Nov-Zelando	Nova Zelanda	GEOG
Okcidenta Azio	Orient Mitjà	GEOG
Orienta Azio	Extrem Orient	GEOG, HIS
Orienta Azio	Orient Llunyà	GEOG, HIS
Oriono	Orió	AST, MIT
Rejno	Rin	GEOG
Romo	Roma	GEOG, HIS
Sokrato	Sòcrates	FIL, NOM, PERS
Sunao	sunna	ISL
Svedujo	Suècia	GEOG
Svisio	Suïssa	GEOG
Svisujo	Suïssa	GEOG
Unikodo	Unicode	KOMP
Vizbadeno	Wiesbaden	GEOG
Zamenhofo	Zamenhof	PERS
Zelando	Zelanda	GEOG
Zeŭso	Zeus	MIT
abako	àbac	ARKI, MAT
abdomeno	abdomen	ANA, ZOO
abelisto	apicultor	
abelo	abella	ZOO
abelujo	rusc	
acero	auró	BOT
advento	Advent	KRI
aerometro	aeròmetre	FIZ
afina	afí	MAT
aidoso	sida	BAK, MED
aidosulo	sidós	
ajatolo	aiatolçlà	ISL
ajlo	all	BOT, KUI
akademio	acadèmia	EVI
akademio	acadèmia	EVI
akordo	acord	GRA, JUR, MUZ
akropolo	acròpoli	ARKI
akrostiĥo	acròstic	POE
akselo	aixella	ANA
aktinio	actini	KEM, ZOO
aktiniumo	actini	KEM
akto	acte	JUR, TEA
akto	acta	JUR, TEA
akumuli	acumular	MAH
akvaforto	aiguafort	BELA
akvilegio	aquilègia	BOT
alabastro	alabastre	MIN
albumino	albúmina	MED
aldehido	aldehid	KEM
aleuto	aleuta	
alia	altre	
alia	altre	
alia	altri	
alibio	coartada	
alie	d'altra manera	
alie	d'una altra manera	
alie	altrament	
aliflanke	per altra banda	
aliigi	transformar	
aliiĝi	transformar-se	
alineo	paràgraf	ARK, TIP
alineo	sagnat	ARK, TIP
alio	una altra cosa	
alio	el contrari	
aliteracio	alçliteració	POE
alivesti	transvestir	
alkazaro	alcàsser	ARKI
almanako	almanac	
almanaĥo	almanac	RAR
alopecio	calvície	MED
alopecio	calbesa	MED
alopecio	alopècia	MED
altmaro	marea alta	MAR
aluno	alum	
ambono	ambó	ARKI, REL
amboso	enclusa	ANA
ametisto	ametista	MIN
amika	amistós	
amika	amical	
amikeco	amistat	
amikino	amiga	
amikiĝi	fer amistat	
amiko	amic	
ampermetro	amperímetre	ELE, FIZ
amplifikatoro	amplificador	ELE
analfabeto	analfabet	
analogia	anàleg	
analogio	analogia	
anarkismo	anarquisme	EVI
anarkisto	anarquista	EVI
anastigmata	anastigmàtic	FOT
anfrakto	anfractuositat	ANA, MIN
anfrakto	cavitat	ANA, MIN
angio	vas	ANA, BOT
animi	animar	
animo	ànima	FIG, FIL, REL
anksia	ansiós	
anksio	ansietat	PSI
anstataŭ	en lloc de	
anstataŭ	en comptes de	
anstataŭigi	substituir	
anstataŭo	substitut	RAR
anstataŭo	reemplaçament	RAR
anstataŭo	substitució	RAR
antaŭvidi	preveure	
antifrazo	antífrasi	BELE, LIN
antipirino	antipirina	MED
antracito	antracita	MIN
antrakso	àntrax	MED
antropometrio	antropometria	
antropomorfismo	antropomorfisme	FIL
anuso	anus	ANA
aorto	aorta	ANA
apatito	apatita	MIN
apaĉo	apatxe	POL
apendico	apèndix	ANA, TIP
apofizo	apòfisi	ANA
apologo	apòleg	BELE
apostato	apòstata	
apoĝaturo	appoggiatura	MUZ
arabesko	arabesc	
arakido	cacauet	BOT
arbalesto	ballesta	
arbitracii	arbitrar	
arbitracio	arbitratge	EKON, JUR
ardezo	pissarra	MIN
areometro	aeròmetre	
arida	àrid	GEOG
ario	ària	MUZ
arkitravo	arquitrau	ARKI
arta	artístic	
artaĵo	obra d'art	
artefarita	artificial	
arterio	artèria	ANA, FIG
arterio	artèria	ANA, FIG
arteza	artesià	
artik(ig)i	articular	ARK, FON
artik(ig)i	articular	ARK, FON
artikiga punkto	punt d'articulació	ARK, FON
artiko	articulaciò	ANA, TEK
artiko	articulació	ANA, TEK
artikpieduloj	artròpodes	ZOO
artisto	artista	BELA
arto	art	
arĥaismo	arcaisme	
asketismo	ascetisme	
asketo	asceta	
aspra	aspre	FIG, RAR
astateno	àstat	KEM
astato	àstat	KEM
astenio	astènia	MED
atavismo	atavisme	GEN
ateismano	ateu	
ateismo	ateisme	FIL
ateisto	ateu	REL
atonio	atonia	MED
atrepsio	atrèpsia	MED
atropino	atropina	KEM
avalo	aval	EKON
aveno	civada	AGR, BOT
aviadisto	aviador	
aviadisto	pilot	
azeno	ase	FIG, ZOO
azeno	ruc	FIG, ZOO
azeno	burro	FIG, ZOO
azeno	somer	FIG, ZOO
aziano	asiàtic	
azteka	asteca	
azteka	nàhuatl	
azteko	asteca	HIS
azuleĥo	rajola	ARKI, BELA
aĵura	calat	
aŭtisto	automobilista	
aŭtomobilisto	automobilista	
aŭtomobilo	automòbil	AUT
aŭtonomio	autonomia	
aŭtuno	tardor	FIG, KAL
ba	bah!	
balenedoj	balènids	ZOO
balustrado	barana	ARKI
bantuko	tovallola	TEKS
barbfiŝo	barb	ZOO
barbhava	barbat	
barbisto	barber	
barblano	pèl moixí	
barbo	barba	ANA
barbulo	barbut	
bareliefo	baix relleu	BELA
baremo	barem	
bario	bari	KEM
barkarolo	barcarola	MUZ
batato	batata	BOT
batato	moniato	BOT
batisto	batista	TEKS
baŭdo	baud	TEL
belarta	artístic	
belartaĵo	obra d'art	
belarto	belles arts	BELA
bergamoto	bergamota	BOT
beribero	beri-beri	MED
berilo	beril	MIN
betono	formigó	KON
bienetato	cadastre	JUR, RAR
biero	cervesa	KUI
bioĥemiisto	bioquímic	
bioĥemio	bioquímica	BIO, SCI
birdo	ocell	FIG, ZOO
birdo	pardal	FIG, ZOO
bisekcanto	bisectriu	MAT
bismuto	bismut	KEM
bito	bit	KOMP, MAR
blazono	blasó	HER
blendi	blindar	
blendo	blindatge	KEM, MIL, MIN
blenoragio	blennorràgia	MED
blenoreo	blennorrea	MED
bofilino	nora	GEN
bofilino	jove	GEN
bofilo	gendre	GEN
bonzo	bonze	
borakso	bòrax	KEM
brakicefalo	braquicèfal	ANA
brano	segó	
brano	bren	
breĉo	breixa	
budhismo	budisme	
budhisto	budista	
budhano	budista	
budho	Buda	
buleno	bolina	MAR
buo	boia	MAR
buŝtuko	tovalló	TEKS
caro	tsar	POL
cemento	ciment	ANA, TEK
ceramikaĵo	ceràmica	
ceramikisto	ceramista	
ceramiko	ceràmica	
cicero	cícero	TIP
cico	mugró	ANA
cicumo	tetina	
cimitaro	simitarra	
da	de	
dago	daga	
daltonismo	daltonisme	MED
damasko	domàs	TEKS
damasko	damàs	TEKS
dancarto	dansa	BELA, MUZ
danci	ballar	MUZ
danci	dançar	MUZ
defetismo	derrotisme	RAR
deklaracio	declaració	
dekokt(aĵ)o	decocció	KUI, MED
delegacio	delegació	
delegi	delegar	
delegitaro	delegació	
delegito	delegat	
delica	deliciós	RAR
delico	delícia	RAR
demamigi	deslletar	
dementi	desmentir	
denaro	denari	EKON
dermatozo	dermatosi	MED
derviŝo	dervix	ISL, REL
desegnarto	dibuix	BELA
determinanto	determinant	MAT
determini	determinar	GRA
determinilo	determinatiu	GRA
determino	determinació	GRA
devono	devoniano	MIN
dia	diví	FIG
diabolo	diàbolo	SPO
diafana	translúcid	
diakono	diaca	KRI
dialektiko	dialèctica	FIL, MAH
diastazo	diastasa	KEM
diatezo	diàtesi	MED
diatona	diatònic	MUZ
dieso	coixinet	KOMP, MUZ
digesti	digerir	FIG
digestiga	digestiu	
digesto	digestió	FIZL
digitalino	digitalina	KEM
diismo	deisme	FIL
dinamismo	dinamisme	FIL
dio	déu	FIL, MIT, REL
dipatrino	marededéu	KRI
diservo	missa	REL
diservo	ofici diví	REL
diskriminanto	discriminant	MAT
dispepsio	dispèpsia	MED
dispneo	dispnea	MED
dispozicio	disposició	JUR, MED
dispozicio	predisposició	JUR, MED
disprozio	disprosi	KEM
disurio	disúria	MED
ditirambo	ditirambe	BELE, FIG, POE
ditirambo	lloança	BELE, FIG, POE
diĥotomio	dicotomia	SCI
dominikano	dominic	KAT
domo	casa	ARK, ARKI, GEN
dorna	espinós	FIG
dornejo	esbarzer	
dornejo	bardissa	
dornejo	romeguera	
dornfiŝeto	espina	
dorno	espina	FIG
dorsosako	motxila	
doto	dot	
doĝo	dux	
drakona	draconià	
du	dos	
du	dues	
dukato	ducat	EKON, HIS
duobla	doble	
duonfilino	fillastra	GEN
duonfilo	fillastre	GEN
duoniganto	bisectriu	EVI, MAT
duono	meitat	
duopolo	duopoli	EKON
dupleksa	dúplex	TEL
duuma	binari	KOMP, MAT
ebonisto	ebenista	
ebonito	ebonita	ELE, KEM
ebono	eben	
edemo	edema	MED
efika	eficaç	
efika	efectiu	
efikeco	eficàcia	
efiki	tenir efecte	
efiko	efecte	
egalanimeco	equànimement	
egalpezo	equilibri	
ejnŝtejnio	einsteni	KEM
ekesti	comparèixer	
ekimozo	equimosi	MED
ekino	eriçó de mar	ZOO
ekliptiko	eclíptica	AST
eklogo	ègloga	BELE, POE
eksciteco	excitació	
eksciti	excitar	FIG
ekslibriso	ex-libris	
ekspliki	explicar	
ekspozicii	exposar	
ekspozicio	exposició	
ekumena koncilio	concili ecumènic	KAT, KRI
ekzemo	èczema	MED
elegio	elegia	BELE, POE
elektrolizi	electrolitzar	ELE, KEM
elektrolizo	electròlisi	ELE, KEM
elektroskopo	electroscopi	ELE
elektroterapio	electroteràpia	MED
elitro	èlitre	ZOO
emetiko	emètic	MED
eminentulo	eminència	
endivio	endívia	BOT
endokarpo	endocarpi	BOT
entablemento	entaulament	ARKI
enterito	enteritis	MED
entrepreni	emprendre	
entreprenisto	empresari	EKON
enua	avorrit	
enui	avorrir-se	
enuiga	avorrit	
enuigi	avorrir	
enuo	avorriment	
enviema	envejós	
envii	tenir enveja	
envii	envejar	
enviinda	envejable	
envio	enveja	
eoceno	eocè	GEOL
ependimo	epèndima	ANA
epigastro	epigastri	ANA
epigloto	epiglotis	ANA
epigramo	epigrama	BELE, POE
epitelio	epiteli	ANA
erao	era	EVI, FIG, GEOL, KAL
erbio	erbi	KEM
ergo	erg	TEK
erizipelo	erisipela	MED
ermito	ermità	FIG, REL
ermito	anacoreta	FIG, REL
erotomanio	erotomania	MED
esenca	essencial	
esenco	essència	FIL, KOMUNE, KRI
eskudo	escut	
esperantismo	esperantisme	ESP, LIN
esperantisto	esperantista	ESP
estanteco	present	GRA
estaĵo	ésser	
estaĵo	ens	
esti	ser	
esti	estar	
estigi	causar	
estigi	ocasionar	
estigi	provocar	
estigi	suscitar	
estinteco	passat	GRA
estiĝi	esdevenir	
estonteco	futur	GRA
estuaro	estuari	GEOG
estulo	ésser	
estulo	ens	
etilo	etil	KEM
etmoido	etmoide	ANA
etnologo	etnòleg	SCI
etologio	etologia	SCI
eĥino	eriçó de mar	ZOO
eĥo	eco	FIG, KOMP
eŭgeniko	eugenèsia	SCI
eŭkalipto	eucaliptus	BOT
eŭropio	europi	KEM
fago	faig	BOT
fagocito	fagòcit	MED
fajenco	pisa	TEK
fakiro	faquir	REL
faksi	enviar un fax	TEL
faksilo	fax	
faksnumero	número de fax	
fakso	fax	TEK
fakso	facsímil	TEK
falĉilo	dalla	AGR
fandango	fandango	MUZ
farandolo	faràndula	MUZ
farboplato	paleta	BELA
faringo	faringe	ANA
farmaciaĵo	fàrmac	MED
farmaciisto	farmacèutic	MED
farmacio	farmàcia	MED
farmakologio	farmacologia	MED
farmakopeo	farmacopea	MED
fascina	fascinant	FIG
fascini	fascinar	
fascino	fascinació	
faŝismo	feixisme	MAH, POL
faŝisto	feixista	
felto	feltre	TEKS
ferbetono	formigó armat	KON
subferigita betono	formigó armat	KON
armita betono	formigó armat	KON
fermi	tancar	FIG
fermi	tancar	FIG
festivalo	festival	
fibro	fibra	FIG, TEK, TEKS
fibromo	fibroma	MED
filharmonio	filharmònica	MUZ
filigi	afillar	GEN
filino	filla	GEN
filo	fill	GEN
fistulo	fístula	MED
fitoterapio	fitoteràpia	MED
fiŝ(kapt)i	pescar	
fiŝĉasi	pescar	
fiŝhoko	ham	
fiŝisto	peixater	
fiŝo	peix	ZOO
flako	toll	
flako	bassiol	
flako	bassa	
flano	flam	KUI
flegmono	flemó	MED
fliki	adobar	FIG
fliki	aparracar	FIG
fliki	apedaçar	FIG
fliki	reparar	FIG
floko	floc	
fluoro	fluor	KEM
foliaro	fullatge	
folkloro	folklore	BELA
fonetismo	fonetisme	LIN
fono	fons	
foresti	ser absent	
forgesi	oblidar	
forgesi	oblidar-se	
formaldehido	formaldehid	KEM
fortreso	fortalesa	ARKI, MIL
fotelo	cadira de braços	
fotelo	butaca	
fotelo	poltrona	
fototelegrafi	fototelegrafiar	ARK, TEL
fototipio	fototípia	TIP
frankolino	francolí	ZOO
fripono	trapella	
fripono	truà	
fundamenta	fonamental	ESP, FIG, GRA, KON
fundamenta	fonamental	ESP, FIG, GRA, KON
fundamenti	fonamentar	
fundamentismo	fonamentalisme	ESP, REL
fundamento	fonaments	FIG, KON
fundamento	fonament	FIG, KON
furzi	pet	
gambito	gambit	SPO
gargari	esbandir	FIG
gargari	gargaritzar	FIG
genealogio	genealogia	GEN, SCI
gerbilo	jerbu	ZOO
gimnasto	gimnasta	
glicirizo	regalíssia	BOT
glicirizo	regalèssia	BOT
glita	relliscós	FIG
glita	lliscadís	FIG
glitiga	relliscós	FIG
glitiga	lliscadís	FIG
gliti	lliscar	FIG
gliti	patinar	FIG
gliti	lliscar	FIG
gliti	patinar	FIG
gliti	relliscar	FIG
gliti	resquitllar	FIG
glitilo	patí	
glito	lliscament	FON, POE
glito	patinatge	FON, POE
glitŝuo	patí	SPO
glugli	clapotejar	
gluglo	clapoteig	
gnejso	gneis	MIN
gonokoko	gonococ	MED
graco	gràcia	KRI
grinci	grinyolar	
grinci	carrisquejar	
grinci	xerricar	
grunti	grunyir	
guano	guano	AGR
gutaperko	gutaperxa	KEM
haloo	halo	AST, FOT
hieraŭ	ahir	
himeno	himen	ANA, BOT
historia materiismo	materialisme històric	FIL, HIS, MAH
honorario	honoraris	EKON
horaro	horari	
horlibro	horari	
hordeo	ordi	AGR, BOT
hunda	caní	FIG
hundo	gos	ZOO
hungara	hongarès	
hungara	magiar	
hungaro	hongarès	
hungaro	magiar	
hura	hurra	
iai	bramar	
iao	bram	
ikonostazo	iconòstasi	KRI
iktero	icterícia	ARK, MED
ileo	íleum	ANA
ileo	ili	ANA
iluminado	ilçluminació	
ilumini	ilçluminar	
imamo	imam	ISL
imanenta	immanent	FIL
imperativo	imperatiu	FIG, GRA
inaŭguri	inaugurar	
ingoto	lingot	
inkandesko	incandescència	
insigno	insígnia	HER
insigno	ensenya	HER
insigno	emblema	HER
instigi	instigar	
interakto	entreacte	TEA
interakto	intermedio	TEA
interalie	entre d'altres	
interpreti	interpretar	
interpreti	interpretar	
interpretilo	intèrpret	KOMP
interpreto	interpretació	
interpunkcio	puntuació	TIP
involucio	involució	MAT
islamano	musulmà	REL
islamano	mahometà	REL
islamano	muslim	REL
islamismo	islamisme	POL
islamisto	islamista	POL
islamo	islam	ISL, REL
istmo	istme	GEOG
izometria	isomètric	MAT
izomorfia	isomorf	MAT
izomorfio	isomorfisme	MAT
ja	certament	
ja	de debò	
ja	en efecte	
ja	en veritat	
jahurto	iogurt	KUI
jaketo	jaqueta	TEKS, TIP
jako	jaqué	TEKS
jakobeno	jacobí	POL
jakobia	jacobià	
jakobia	jacobiana	
jakobia determinanto	determinant jacobià	MAT
jogurto	iogurt	KUI
jordania	jordà	
jordaniano	jordà	
juki	picar	
juniperbrando	ginebra	KUI
junipero	ginebre	BOT
jurisdikcio	jurisdicció	JUR
juvelarto	joieria	BELA
kabla televido	televisió per cable	TEL
kaco	cigala	ANA, VULG
kaco	titola	ANA, VULG
kaco	pixa	ANA, VULG
kaco	ocell	ANA, VULG
kaco	pardal	ANA, VULG
kadio	cadi	ISL
kafkruĉo	cafetera	
kakofonio	cacofonia	MUZ, RAR
kalfatri	calafatar	MAR
kalifo	califa	HIS, ISL, POL, REL
kalifujo	califat	HIS, ISL, POL, REL
kalkaneo	calcani	ANA
kalkaneo	calcany	ANA
kalsono	calces	TEKS
kalsono	bragues	TEKS
kalsono	calçotets	TEKS
kambio	lletra de canvi	EKON
kameleono	camaleó	ZOO
kameo	camafeu	BELA, TEK
kamerlingo	camarlenc	KAT
kancero	càncer	MED
kanoniko	canonge	KAT
kantiko	càntic	MUZ, REL
kaolino	caolí	KEM
kaosa	caòtic	
kaose	caòticament	
kaptilo	trampa	
karabeno	carrabina	MIL
karafo	garrafa	
karamelo	caramel	KUI
karateo	karate	SPO
karavano	caravana	ESP
karavelo	caravel.la	SHI
karbono	carboni	KEM
kardio	càrdia	ANA
kardio	càrdies	ANA
kareo	curry	KUI
karikaturo	caricatura	
kartilago	cartílag	ANA
kartoĉo	cartutx	MIL, SPO
karuselo	carrusel	SPO
kaserolo	casserola (amb mànec)	KUI
kaserolo	cassola (amb anses)	KUI
kasko	casc	MIL
kastri	castrar	
kata	felí	
katafalko	cadafal	
katalepsio	catalèpsia	MED
katalogo	catàleg	
kataplasmo	cataplasma	MED
katapulti	catapultar	
katapulto	catapulta	AVI, HIS, MIL, TEK
katarakto	cataracta	EVI, MED, RAR
katastro	cadastre	JUR
katastrofo	catàstrofe	
katekismo	catecisme	
katekisto	catequista	REL
kateĥizi	catequitzar	REL
kateĥizisto	catequista	REL
kateĥizo	catequesi	REL
kato	gat	ZOO
katodo	càtode	ELE
kaviaro	caviar	KUI
kazako	casaca	TEKS
kazeino	caseïna	KEM
kazuistiko	casuística	REL
kaĝo	gàbia	
kaŭcio	fiança	EKON, JUR
kaŭterizi	cauteritzar	MED
kaŭterizilo	cauteri	
kefiro	quefir	KUI
kerno	nucli	BOT, FIG, KOMUNE, MAT
kilo	quilla	MAR
kilogramo	quilogram	FIZ
kilometro	quilòmetre	
kilometro	kilòmetre	
kilovolto	quilovolt	ELE
kimono	quimono	TEKS
kinarto	cinema	BELA, KIN
kinarto	setè art	BELA, KIN
kinematiko	cinemàtica	FIZ, MAT
kinino	quinina	BIO, MED
kiraso	cuirassa	MIL, ZOO
kirli	batre	
kirli	remenar	
kirli	deixatar	
kisi	besar	FIG
kiso	bes	
kiso	petó	
kiso	besada	
kitaro	cítara	MUZ
klano	clan	
klara	clar	
klare	clarament	
klarigi	aclarir	
klarneto	clarinet	MUZ
klavceno	clavicordi	MUZ
klaŭno	pallasso	
klaŭstro	claustre	ARKI, KRI
klaŭzo	clàusula	EKON, JUR
kleo	clau	MUZ
kleriko	clergue	REL
kliniko	clínica	MED
klitoro	clítoris	ANA
kloroformo	cloroform	KEM, MED
klostrofobio	claustrofòbia	MED
kluki	escatainar	
kluzo	resclosa	KOMP, MAR
koaguli	coagular	MED
kobalto	cobalt	KEM
kodekso	códex	JUR, MED, TIP
kodekso	farmacopea	JUR, MED, TIP
kodicilo	codicil	JUR
koeficiento	coeficient	KOMUNE, MAT
koiti	copular	
koito	coit	
koito	còpula	
kojlo	còlon	ANA
kokcigo	còccix	ANA
koketi	coquetejar	
koksalgio	coxàlgia	MED
kolbo	culata	MIL, SPO
kolesterolo	colesterol	BIO, KEM
kolibro	colibrí	ZOO
koliko	còlic	MED
kolirio	colçliri	MED
kolostro	calostre	ANA
koltuko	bufanda	TEKS
kolubro	colobra	ZOO
komao	coma	MUZ
komata	comatós	
komato	coma	MED
komikeco	còmic	
komitato	comitè	
kompaso	compàs	
kompendio	compendi	
kompleksio	complexió	MED
kompozicio	composició	MUZ
kompreso	compresa	MED
konceptado	concepció	
koncepto	concepte	FIL
koncesii	concedir	EKON, JUR
koncesio	concessió	EKON, JUR
koncesiulo	concessionari	EKON, JUR
koncilio	concili	KRI
koncipi	concebre	
koncipo	concepció	
kondensatoro	condensador	ELE, FOT
kondomo	preservatiu	MED
kondomo	condom	MED
kondomo	condó	MED
kondomo	profilàctic	MED
kondoro	còndor	ZOO
konduktanco	conductància	ELE, FIZ
konduti	comportar-se	
konduti	captenir-se	
konduti	portar-se	
konduto	comportament	
kongesti	congestionar	
kongesto	congestió	MED
konglomerato	conglomerat	
konjako	conyac	KUI
konjunktivito	conjuntivitis	MED
konjunktivo	conjuntiva	ANA, LIN
konkeri	conquerir	FIG
konklavo	conclave	KAT
konkoido	concoïde	MAT
konkordo	concòrdia	
konkur(ad)o	competició	
konkuri	competir	
konkurso	concurs	
konoido	conoide	MAT
konscienco	consciència	FIL
konservatorio	conservatori	MUZ
konstati	constatar	
kontingento	contigent	
kontrabandaĵo	gènere de contraban	
kontrabandaĵo	matuta	
kontrabandisto	contrabandista	
kontrabando	contraban	EKON, JUR
kontrabaso	contrabaix	MUZ
kontralto	contralt	MUZ
kontrapunkto	contrapunt	MUZ
kontraŭkoncipa	anticonceptiu	MED
kontraŭkoncipa	contraceptiu	MED
kontraŭkoncipilo	anticonceptiu	MED
kontraŭkoncipilo	contraceptiu	MED
kontraŭleĝa	ilçlegal	JUR
kontraŭpezo	contrapès	
kontribuanto	colçlaborador	
kontribuisto	colçlaborador	
kontribuaĵo	contribució	
kontribui	contribuir	
konturo	contorn	
kontuzi	contusionar	MED
kontuzo	contusió	MED
konvencio	convenció	HIS, JUR, POL
korbelo	mènsula	ARKI
korbo	cistell	SPO
korko	suro	
korko	tap	
korneo	còrnia	ANA
korneto	corneta	MUZ
korodi	corroir	KEM
korolo	corol.la	BOT
korpusklo	corpuscle	SCI
korseto	cotilla	TEKS
korveto	corbeta	HIS, MAR, MIL, ZOO
kosmogonio	cosmogonia	
kosmologio	cosmologia	SCI
kosmopolitismo	cosmopolitisme	POL
kosmopolito	cosmopolita	
kovarianco	covariància	MAT
kovri	cobrir	
kovrilo	tapa	FIG
kovrilo	coberta	FIG
kovrilo	manta	FIG
kovrilo	tapes	FIG
kovrilo	coberta	FIG
kovro	coberta	MAT
kramfo	rampa	MED
krampi	grapar	FIG
krampilo	grapadora	
krampo	grapa	MAT, TIP
kravato	corbata	TEKS
kraĉaĵo	escopinada	FIZ
kraĉaĵo	salivada	FIZ
kraĉi	escopir	
kraĉujo	escopidora	
kreditoro	creditor	EKON
kreozoto	creosota	
kresto	cresta	
kretaceo	cretaci	GEOL
kreteno	cretí	FIG
krimo	crim	JUR
krino	crin	RAR, ZOO
kripla	discapacitat	
kriplaĵo	minusvalidesa	MED
kriplaĵo	discapacitat	MED
kriptono	criptó	KEM
krisolo	gresol	KEM, TEK
kriterio	criteri	
kromartikuloj	xenartres	ZOO
kromio	crom	KEM
kromosomo	cromosoma	BIO
kronika	crònic	MED
krotalo	cròtal	ZOO
krucifikso	crucifix	KRI
kruela	cruel	
krupiero	crupier	SPO
kruro	cama	ANA
kruro	petge	ANA
kruro	pota	ANA
kruĉo	gerra	
kufo	còfia	TEKS
kukurbacoj	cucurbitàcies	BOT
kulero	cullera	KUI
kulinara	culinari	KUI
kulmina	culminant	
kulmini	culminar	AST
kulmino	culminació	AST
kulmino	culminació	AST
kumuluso	cúmul	MET
kunalie	amb altres	
kunvarianco	covariància	MAT
kupeo	compartiment	FER
kupolo	cúpula	ARKI
kurso	curs	EVI, KOMP, PED
kuzino	cosina	GEN
kuzo	cosí	GEN
kvakero	quàquer	KRI
kvartalo	barri	
kvazaro	quàsar	AST
kverko	roure	BOT
kvin	cinc	
kvina	cinquè	
kvintesenco	quinta essència	
kvinteto	quintet	MUZ
kvorumo	quòrum	
lakmuso	tornassol	KEM
laktuko	enciam	BOT
lama	coix	FIG
lami	coixejar	
lamulo	coix	
lapiso	nitrat de plata	MIN
lasero	làser	FIZ, TEK
latiso	reticle	MAT, TEK
latrono	lladre	POE
latuno	llautó	KEM
lavurso	ós rentador	ZOO
lavurseto	ós rentador	ZOO
laŭdano	làudanum	KEM, MED
laŭdano	làudan	KEM, MED
laŭleĝa	legal	JUR
laŭta	alt	
laŭtparolilo	altaveu	
leciono	lliçó	EVI
leciono	classe	EVI
lecitino	lecitina	KEM, MED
lekcii	impartir	
lekcio	lliçó	PED
leki	llepar	FIG
leksiko	lèxic	LIN, RAR
leksikografio	lexicografia	LIN
lemo	lema	MAT
lesivo	lleixiu	
levrelo	llebrer	ZOO
leĝa	legal	
leĝaro	legislació	JUR
leĝigi	legalitzar	
leĝo	llei	JUR, KOMUNE, SCI
libido	libido	PSI
lieno	melsa	
lignoŝuo	esclop	TEKS
lignoŝuo	galotxa	TEKS
ligna ŝuo	esclop	TEKS
ligna ŝuo	galotxa	TEKS
likva	líquid	FIZ
likvaĵo	líquid	FIZ
likvigi	liquar	
littuko	llençol	TEKS
litotuko	llençol	TEKS
liturgio	litúrgia	KAT, KRI
lozanĝo	rombe	HER, MAT
lozanĝo	losange	HER, MAT
maceri	macerar	KEM, KUI, MED
magazino	revista	
magmo	magma	GEOL, MAT
magnetismo	magnetisme	
magnetito	magnetita	MIN
magneto	imant	
magneto	atractiu	
magneto	encant	
magnezio	magnesi	FOT, KEM, MED
maizo	blat de moro	AGR, BOT
maizo	moresc	AGR, BOT
majoliko	majòlica	
majonezo	maionesa	KUI
majordomo	majordom	
majstro	mestre	
makaronio	macarrons	KUI
malakito	malaquita	MIN
malaltmaro	marea baixa	MAR
malamiko	enemic	MIL
malario	malària	MED
malesti	manca	
malesti	falta	
malfermi	obrir	FIG
malklara	fosc	
malkovri	descobrir	
mallonga	corto	FON, POE
mallongigo	abreviatura	GRA
malpeza	lleuger	
malpezigi	alleugerir	
malpezigi	alleugerar	
malpezigi	alleujar	
malplena	buit	
malplenumi	incomplir	
malpura	brut	
malpurigi	embrutar	
malpurigi	embrutir	
malriĉa	pobre	EKON
malriĉigi	empobrir	
malriĉiĝi	empobrir-se	
malriĉo	pobresa	
malriĉulo	pobre	
malseka	mullat	
malseketa	humit	
mambestoj	mamífers	ZOO
mameto	mugró	ANA
mamnutri	alletar	
mamo	pit	ANA
mamo	mamella	ANA
mampinto	mugró	ANA
mamsuĉi	mamar	
mamuloj	mamífers	ZOO
mamzono	sostenidors	TEKS
manao	mannà	BIB
mandareno	mandarí	
mandarino	mandarina	BOT, KUI
mandato	mandat	
manifestacio	manifestació	
maniko	màniga	TEKS
manometro	manòmetre	
maparo	atlas	GEOG
maparo	atles	GEOG
mapo	mapa	AST, GEOG
marerinaco	eriçó de mar	KOMUNE, ZOO
margarino	margarina	KUI
markaŝtano	eriçó de mar	KOMUNE, ZOO
maro	mar	EVI, FIG, GEOG
marseljezo	Marsellesa	
marteso	mart	ZOO
marto	març	KAL
marĝeno	marge	
masaĝo	massatge	
materiismo	materialisme	FIL
mazurko	masurca	MUZ
maĉi	mastegar	
maĥinacio	maquinació	RAR
maŭzoleo	mausoleo	ARKI
medikamento	medicament	MED
medikamento	medecina	MED
medio	medi	EKOL, KEM, POL
mediti	meditar	
mediumo	mèdium	
mejlo	milla	
mekaniko	mecànica	
melinito	melinita	KEM, MIL
melodramo	melodrama	
memforgeso	abnegació	
sinforgeso	abnegació	
menhiro	menhir	ARKE
meningito	meningitis	MED
meningo	meninge	ANA
mensogi	mentir	FIG
mensogo	mentida	
menstruo	menstruació	MED
menstruo	regla	MED
menstruo	període	MED
mentoro	mentor	PED
merkantilismo	mercantilisme	EKON, JUR
mestizo	mestís	
metabolo	metabolisme	BIO
metaloido	metalçloide	KEM
metalurgio	metalçlúrgia	
metatarso	metatars	ANA
metonimio	metonímia	LIN
metopo	mètopa	ARKI
metronomo	metrònom	MUZ
meĥanismo	mecanisme	FIG, FIL
meĥanismo	mecanisme	FIG, FIL
mi	jo	
mi	mi	
miaŭi	miolar	
miaŭo	miol	
mikozo	micosi	MED
milicio	milícia	
milico	milícia	
miligramo	milçligram	
milimetro	milímetre	
mimiko	mímica	
minareto	minaret	ISL
mineralo	mineral	MIN
mineralogio	mineralogia	MIN, SCI
ministerio	ministeri	
minus	menys	FIZ, MAT
miraĝo	miratge	FIG, FOT
mistralo	mestral	MET
mitingo	míting	
mnemotekniko	mnemotecnia	
moderna	modern	
modifi	modificar	
mokaseno	mocassí	TEKS
molibdeno	molibdè	KEM
momenta	momentani	FON
momento	moment	
mongola	mongol	
mongolo	Mongòlia	
monolito	monòlit	ARKI
monomo	monomi	MAT
monoplano	monoplà	AVI
monoteisto	monoteista	REL
moskeo	mesquita	ISL, REL
mosto	most	
muezino	muetzí	ISL
muftio	muftí	ISL
mulato	mulat	
multiplikendo	multiplicand	ARK, MAT
municio	munició	MIL
muzeo	museu	ARKI
muŝbirdo	colibrí	ZOO
nacionalismo	nacionalisme	ARK
naftalino	naftalina	KEM
najado	nàiade	
najli	clavar	
najlo	clau	
narciso	narcís	BOT
natrio	sodi	KEM
naztuko	mocador	TEKS
neesto	inexistència	
neforgesebla	inoblidable	
nekropolo	catacumbes	
neodimo	neodimi	KEM
neptunio	neptuni	KEM
netipa pneŭmonio	pneumònia atípica	MED
neŭralgio	neuralgia	MED
neŭrozo	neurosi	MED, PSI
neŭtono	newton	FIZ
neŭtrala	neutral	
nigra truo	forat negre	AST
nimbuso	nimbus	MET
nimbuso	nimbe	MET
niobo	niobi	KEM
nitroglicerino	nitroglicerina	KEM, MIL
nobelio	nobeli	KEM
noci	danyar	RAR
noci	perjudicar	RAR
nomada	nòmada	
nomadismo	nomadisme	
nomado	nòmada	
numeratoro	numerador	MAT
oazo	oasi	FIG, GEOG
obelisko	obelisc	ARKI
objektiva	objectiu	
objektiveco	objectivitat	
obstaklo	obstacle	
obtuza	obtús	FON, MAT, MUZ
oceano	oceà	GEOG
odori	olorar	FIG
odoro	olor	
oferti	oferir	EKON
oftalmologio	oftalmologia	SCI
oktanto	octant	AST, MAT
okulvitroj	ulleres	FOT
oligarkio	oligarquia	POL
oligopsonio	oligopsoni	EKON
omleto	truita	KUI
onklino	tia	GEN
onklo	oncle	GEN
oponi	oposar	
orelo	orella	ANA, FIG
orgasmo	orgasme	FIZL
orgojla	arrogant	
ornamarto	arts decoratives	BELA
ortocentro	ortocentre	MAT
oska	osc	
osko	osc	HIS
ovalo	oval	MAT
paca	pacífic	FIG
pacifismo	pacifisme	POL
pacifisto	pacifista	POL
pacigi	pacificar	
pacismo	pacifisme	
pacisto	pacifista	
paco	pau	
pajlo	palla	AGR
pala	pàlçlid	FIG
palaco	palau	ARKI
paletro	paleta	BELA
paliĝi	empalçlidir	
pamfleto	pamflet	BELE
pamfleto	libel	BELE
paneo	avaria	TEK
panero	engruna	
panerumi	arrebossar	KUI
panumi	arrebossar	KUI
panisto	flequer	
panisto	forner	
pano	pa	FIG
pantoflo	espardenya	TEKS
pantoflo	pantofla	TEKS
pantoflo	sabatilla	TEKS
parabolo	paràbola	BELE, MAT
parafino	parafina	
paralizi	paralitzar	
paralizo	paràlisi	
paranojo	paranoia	MED, PSI
paranojulo	paranoic	
parazito	paràsit	EKOL, FIG
parentezo	parèntesi	GRA, TIP
pario	pària	ANA, FIG, TEK
pario	pària	ANA, FIG, TEK
pasaĝero	passatger	TRA
pasaĝero	viatger	TRA
pasia	apassionat	
pasio	passió	
pastelo	pastilla	MED
pasto	pasta	KUI
patelo	ròtula	ANA, ZOO
pato	paella	
paŝtelo	pastel	
pedalo	pedal	
peniso	penis	ANA
pensio	pensió	EKON
pentagono	pentàgon	MAT
pentrarto	pintura	BELA
pepsino	pepsina	
pergameno	pergamí	
perifrazo	perífrasi	LIN
perigeo	perigeu	AST
perihelio	periheli	AST
perimetro	perímetre	MAT
perineo	periné	ANA
periskopo	periscopi	MIL, TEK
peristilo	peristil	ARKI
perpendikulara	perpendicular	MAT
persekuti	perseguir	FIG, JUR
peruko	perruca	
peza	pesat	FIG
pezi	pesar	
pezo	pes	
piano	piano	MUZ
pico	pizza	KUI
pilolo	píndola	MED
pinaklo	pinacle	ARKI
pingveno	pingüí	ZOO
pingvino	pingüí	EVI, ZOO
pinĉi	pinçar	
pinĉilo	pinça	ZOO
pipo	pipa	
piramido	piràmide	ARKI, FIG, MAT
piroteknikaĵo	focs d'artifici	
piroteknikaĵo	focs artificials	
pirotekniko	pirotècnia	
pirozo	pirosi	MED
pispoto	orinal	KOMUNE
pistako	festuc	
pistako	pistatxo	
piĉo	cony	ANA
piĵamo	pijama	TEKS
piŝto	pistó	TEK
planedo	planeta	AST
platano	plàtan	BOT
plena	ple	FIG, MAT
plena	complet	FIG, MAT
plena	enter	FIG, MAT
plena	ple	FIG, MAT
plendi	queixar-se	
plendo	queixa	
plenigi	emplenar	FIG
plenigi	omplir	FIG
plenumi	complir	
plenumi	dur a terme	
plenumiĝi	complir-se	
plenumiĝi	dur-se a terme	
pleonasmo	pleonasme	GRA
pleŭro	pleura	ANA
plipezo	sobrepès	
plumbo	plom	KEM
pluvi	ploure	
pluvo	pluja	MET
pneŭmonio	pneumònia	MED
poemo	poema	EVI, POE
poento	punt	SPO
poeto	poeta	POE
poldero	pòlder	AGR
polico	policia	POL
poligloto	políglota	
politikisto	polític	POL
politiko	política	POL
polko	polca	MUZ
polmo	palma	ANA
pomejo	pomereda	BOT
pomo	poma	BOT
pomujo	pomera	BOT
pomarbo	pomera	BOT
popolo	poble	
postiĉa	postís	RAR
poterno	poterna	ARKI, MIL
poŝtuko	mocador	TEKS
poŭpo	popa	MAR
precepto	precepte	RAR
precipa	principal	
precipe	principalment	
preciza	precís	
precizeco	precisió	
precizigi	precisar	
prefere	preferentment	
prefikso	prefix	
premaĵo	comprimit	MED
premaĵo	pastilla	MED
prepara	preparatiu	
prepara	preparatori	
prepucio	prepuci	ANA
preskribi	prescribir	MED
preskribi	receptar	MED
prezidanto	president	
primitiva	primitiu	
prirabi	robar	
prismo	prisma	MAT
procedi	procedir	
procesoro	processador	KOMP
prociono	ós rentador	ZOO
produto	producto	MAT
promesi	prometre	
promeso	promesa	
prononci	pronunciar	
prototipo	prototip	TEK
prototipo	prototipus	TEK
protruda	protuberant	MED
providenco	providència	
prozo	prosa	
psikologia	psicològic	FIG
psikologiisto	psicòleg	PSI
psikologio	psicologia	FIG, PSI, SCI
pubertulo	púber	MED
pueblo	indi pueblo	
pulminflamo	pneumònia	KOMUNE
pulso	pols	BIO, MUZ
pulso	temps	BIO, MUZ
pundo	lliura	EKON
punika	púnic	
punto	punta	TEKS
pupitro	pupitre	KRI
purgatorio	purgatori	KAT
purismo	purisme	
pusi	supurar	
puso	pus	FIZL, MED
puzlo	puzle	FIG
rabato	rebaixa	EKON
rabato	descompte	EKON
rabi	robar	
rabisto	lladre	
radiano	radiant	MAT
radŝuo	patí	SPO
rafini	refinar	FIG, KEM
raketo	coet	AVI, MIL, SPO, TEK
raketo	coet	AVI, MIL, SPO, TEK
raketo	raqueta	AVI, MIL, SPO, TEK
ramadano	ramadà	ISL, KAL
ranunkolacoj	ranunculàcies	BOT
rasti	rasclar	AGR, HOR
rasti	rampinar	AGR, HOR
rastilo	rastell	AGR, HOR
ratifi	ratificar	JUR
ravi	encantar	
ravioloj	ravioli	KUI
razisto	barber	
reciproka	recíproc	
redunda	redundant	
referendumo	referèndum	JUR
reflekti	reflectir	FIZ
reflekto	reflex	FIZ, MAT
refrakti	refractar	FIZ
refrakto	refracció	FIZ
regula	regular	MAT
regularo	reglament	
reguleco	regularidad	
reguligi	regular	
regulo	regla	
rektumo	recto	ANA
reno	ronyó	ANA
reputacio	reputació	
restado	sojorn	
restado	estància	
restado	permanència	
restado	estada	
retino	retina	ANA
revelacio	revelació	
revolvero	revòlver	MIL
rezignacio	resignació	
rezino	resina	BOT, KEM
rezisti	resistir	ELE, FIZ
rezoluta	decidit	
rezoluta	resolut	
rezolute	decididament	
rezulto	resultat	
rinocero	rinoceront	
ripari	reparar	
riparo	reparació	
ripo	costella	ANA
rito	ritu	
rivero	riu	FIG, GEOG
rizomo	rizoma	BOT
riĉa	ric	EKON
riĉigi	enriquir	
riĉiĝi	enriquir-se	
riĉo	riquesa	
rokoko	rococó	ARKI, BELA
roma	romà	
romanco	romanç	MUZ, POE
romano	romà	BELE
romboido	romboide	MAT
ronki	roncar	
ronki	rinxolar	
ronki	roncar	
ronki	remorejar	
roso	rosada	MET
rozario	rosari	FIG
rubeno	robí	MIN
rubidio	rubidi	KEM
ruino	ruïna	ARKE, FIG
rulŝuo	patí	SPO
rumo	rom	KUI
rutino	rutina	
saboti	sabotatge	
sago	fletxa	MAT
sago	sageta	MAT
sakro	sacre	ANA
sama	contemporani	
sama	correligionari	
samario	samari	KEM
samnito	samnita	HIS
sandalo	sandàlia	TEKS
sangalfluo	congestió	MED
sapo	sabó	
sapumi	ensabonar	
sateno	setí	TEKS
savi	salvar	
saŭco	salsa	
scienco	ciència	SCI
sciuro	esquirol	ZOO
seanco	sesió	BELA, KIN, KOMP, MED
sedativo	sedant	MED
segi	serrar	
segilo	serra	
segilo	xerrac	
segmento	segment	MAT
seka	sec	FIG, TEK
sekalo	sègol	AGR, BOT
sekigi	assecar	
sekretariejo	secretaria	
sekretario	secretari	
sekstanto	sextant	MAR
sektoro	sector	EKON, MAT
sekundo	segon	FIZ, KAL, MAT
sekurrimeno	cinyell de seguretat	TRA
sekurrimeno	cinturó de seguretat	TRA
sekurzono	cinyell de seguretat	TRA
sekurzono	cinturó de seguretat	TRA
semantiko	semàntica	
senbarba	barbamec	
senbarba	imberbe	
sendieco	ateisme	REL
sendiismo	ateisme	REL
sendiulo	ateu	REL
septeto	septet	MUZ
sesio	sessió	
setaro	cítara	MUZ
sezono	estació	KAL
sfinktero	esfínter	ANA
siglo	sigla	GRA, RAR
signifi	significar	
signifo	significat	FIG
silabo	sílçlaba	FON
silfo	sílfide	MIT
silicio	silici	KEM
simulado	simulació	JUR, KOMP, MED
simuli	simular	JUR, KOMP, MED
simulilo	simulador	KOMP, TEK
sinonimo	sinònim	
sintagma	sintagmàtic	LIN
sintagmo	sintagma	LIN
sintaksa	sintàctic	
sintakso	sintaxi	GRA
siroko	xaloc	MET
siropo	xarop	KUI
sistro	sistre	MUZ
skadrono	esquadró	
skalena	escalè	MAT
skatolo	caixa	
skiisto	esquiador	SPO
skio	esquí	SPO
skita	escita	
skolto	boy scout	MIL, SPO
skulptarto	escultura	BELA
skulpti	esculpir	BELA
slava	eslau	
slava lingvo	llengua eslava	LIN
slavisto	eslavista	
slavo	eslau	
snobo	esnob	
sociologia	sociològic	
sociologiisto	sociòleg	POL
sociologio	sociologia	POL, SCI
sociologo	sociòleg	
sofismo	sofisma	
sofo	sofà	
sojlo	llindar	FIG
solisto	solista	MUZ
solventa	solvent	EKON
somere	a l'estiu	
somero	estiu	KAL
spajro	pinacle	ARKI
speciala	especial	
speciale	especialment	
specialisto	especialista	
specifa	específic	FIZ
specifi	especificar	
spektro	espectre	ARK, EVI, FIG, FIZ, MAT
spektro	espectre	ARK, EVI, FIG, FIZ, MAT
spekulativa	especulatiu	
spermo	esperma	ANA
spioni	espiar	
spiono	espia	FIG, MIL, POL
spiralo	espiral	MAT
stacidomo	estació	ARKI, FER
stadiono	estadi	SPO
stani	estanyar	
stano	estany	KEM
stano	júpiter	KEM
stereometrio	estereometria	ARK, MAT
stigmo	estigma	BOT
stilo	estil	
striknino	estricnina	KEM, MED
strofo	estrofa	POE
stroncio	estronci	KEM
stumpigi	amputar	
stumpo	monyó	MED
subita	sobtat	
subita	sobtós	
subtegmento	àtic	
suko	suc	FIG, KUI
sultano	sultà	
superstiĉo	superstició	
surda	sord	FIG
surdulo	sord	
suro	panxell	ANA
surprizi	sorprendre	
sveda	suec	
svedo	suec	
svisa	suís	
sviso	suís	
tabako	tabac	BOT
tablotuko	estovalles	TEKS
tabuo	tabú	FIG, REL
tajloro	sastre	TEKS
taliumo	talçli	KEM
tampono	tampó	
tampono	tampó	
tanino	taní	KEM
tanko	tanc	MIL
tapioko	tapioca	KUI
taverno	taverna	
tegmento	teulada	
tekruĉo	tetera	
telegramo	telegrama	TEL
teleregilo	comandament a distància	
telero	plat	
televidi	veure la televisió	
televidilo	televisor	
televido	televisió	TEK, TEL
teluro	telçluri	KEM
tempio	templa	ANA
tempo	temps	EVI, FIZ, GRA, KAL, MUZ
tempo	temps	EVI, FIZ, GRA, KAL, MUZ
temporalo	os temporal	ANA
tenebro	tenebrositat	POE
teoremo	teorema	MAT
teorio	teoria	
terapio	teràpia	MED
terenregistro	cadastre	JUR
terminalo	terminal	AVI, KOMP, MAR
termometro	termòmetre	
terni	esternudar	
tibio	tibia	ANA
tikli	fer pessigolles	
tikliĝema	tenir pessigolles	
tio estas	es a dir	
tio estas	o sigui	
tiraljoro	franctirador	MIL
titano	titani	AST, KEM, MIT
togo	toga	TEKS
tohuvabohuo	agitació	RAR
tohuvabohuo	bullícia	RAR
tohuvabohuo	confusió	RAR
tohuvabohuo	desgavell	RAR
tohuvabohuo	gran desordre	RAR
tohuvabohuo	enrenou	RAR
tohuvabohuo	merder	RAR
tohuvabohuo	renou	RAR
tolerebla	tolerable	
tolerema	tolerant	
toleri	tolerar	
tolueno	toluè	KEM
tombomonumento	mausoleo	ARKI
tomba monumento	mausoleo	ARKI
tomismo	tomisme	FIL
tonsilo	amígdala	ANA
topazo	topazi	
torio	tori	KEM
torpedo	torpede	MIL
tosti	brindar	
tosto	brindis	KUI
trajno	tren	FER, MIL, TEK
transformatoro	transformador	ELE
transmara	ultramarí	
tranĉeo	trinxera	MIL
travidebla	transparent	
traĥeo	tràquea	ANA, BOT, ZOO
traŭmato	trauma	MED, PSI
tremi	tremolar	
trezorejo	erari	EKON
trezoristo	tresorer	EKON
trezoro	tresor	EKON, FIG
tribunalo	tribunal	JUR
triciklo	tricicle	
tritiko	blat	AGR, BOT
tritiko	forment	AGR, BOT
troti	trotar	
trua	foradat	
truhava	foradat	
trui	foradar	
trui	perforar	
truo	forat	FIG
tulio	tuli	KEM
tunelo	túnel	
tuniko	túnica	TEKS
turbano	turbant	TEKS
tusi	tossir	
tutslavismo	paneslavisme	
uniformo	uniforme	TEKS
unika	únic	
universa	universal	
universala	universal	
universo	univers	
unu	un	
unuanime	unànimement	
varianco	variància	MAT
varti	cuidar	
varti	vigilar	
varti	vetllar	
varti	guardar	
varti	tenir cura	
vaska	basc	
vasko	basc	
vazelino	vaselina	
vefto	trama	TEK, TEKS
velka	pansida	
velki	pansir-se	FIG
venena	verinós	FIG
veneni	enverinar	FIG
veneno	verí	
venerea	veneri	MED
vepro	esbarzer	HOR
vepro	bardissa	HOR
vepro	romeguera	HOR
verando	veranda	ARKI
viando	carn	FRAZ
vidi	veure	
vido	vista	ARK
vidvino	viuda	
vidvo	viudo	
viktualio	vituallas	RAR
vindozulo	usuari de Windows	KOMP
vinjeto	vinyeta	TIP
vipi	assotar	FIG
vipo	fuet	FIG
virtuala	virtual	FIL
virtuozo	virtuós	MUZ
vitamino	vitamina	BIO, MED
viŝtuko	drap	TEKS
volframo	wolframi	KEM
volframo	tungstè	KEM
volframo	wólfram	KEM
volupto	voluptuositat	
vulvo	vulva	ANA
zebro	zebra	ZOO
zebuo	zebú	ZOO
zenito	zenit	AST, FIG
zibelo	mart gibelí	
zono	cinyell	FIG, GEOG, MAT, TEKS
zono	cinturó	FIG, GEOG, MAT, TEKS
zono	cintura	FIG, GEOG, MAT, TEKS
zono	zona	FIG, GEOG, MAT, TEKS
ĉako	xacó	TEKS
ĉapelo	barret	GRA, KOMP, TEKS, TIP
ĉeesti	ser present	
ĉerko	taüt	
ĉirkaŭkovri	recobrir	
ĉizi	cisellar	BELA, BELE, TEK
ĉizilo	cisell	TEK
ĉiĉerono	guia	
ĝino	ginebra	ISL, KUI
ĝui	gaudir	
ĝui	fruir	
ĥameleono	camaleó	ZOO
ĥano	khan	HIS, POL
ĥanujo	khanat	HIS, POL
ĥaosa	caòtic	FIG
ĥaose	caòticament	
ĥaoso	caos	FIG, MIT
ĥaradriedoj	caràdrids	ZOO
ĥaradrio	corriol	ZOO
ĥaradrioformaj	caradriformes	ZOO
ĥemiaĵo	producte químic	
ĥemio	química	KEM, SCI
ĥimero	quimera	FIG, MIT
ĥimo	quim	BIO, FIZL, MED
ĥinino	quinina	MED
ĥirurgo	cirurgià	MED
ĥitino	quitina	BIO, KEM
ĥolero	còlera	MED
ĥolesterolo	colesterol	BIO, KEM
ĥorano	corista	MUZ
ĥoraĵo	coral	MUZ
ĥordo	corda	ZOO
ĥorduloj	cordats	ZOO
ĥorejo	cor	ARKI, KRI
ĥoreo	corea	MED
ĥoreo	ball de Sant Vito	MED
ĥoro	cor	MUZ, TEA
ĵaluzio	persiana	ARKI
ĵibo	floc	MAR
ĵurnalisto	periodista	
ĵurnalo	diari	TIP
ĵurnalo	periòdic	TIP
ŝablono	plantilla	FIG, TEK
ŝablono	patró	FIG, TEK
ŝablono	model	FIG, TEK
ŝablono	estereotip	FIG, TEK
ŝafhundo	gos d'atura	
ŝakludo	escacs	SPO
ŝako	escac	SPO
ŝakpeco	escacs	SPO
ŝaktabulo	escaquer	SPO
ŝankro	xancre	MED
ŝelko	elàstics	TEKS
ŝelo	escorça	BOT, KOMP
ŝelo	corfa	BOT, KOMP
ŝelo	pell	BOT, KOMP
ŝelo	clofolla	BOT, KOMP
ŝelo	closca	BOT, KOMP
ŝijaismo	xiisme	ISL
ŝijaisto	xiïta	ISL
ŝilingo	xíling	
ŝmiri	untar	EKON, FIG
ŝoforo	xofer	TRA
ŝovinismo	xovinisme	
ŝranko	armari	
ŝuo	sabata	TEKS
ŝviti	suar	FIG
ŝvitiĝi	traspuar	
ŝvito	suor	ANA, MED
